,Node,Degree,In degree nodes,Out degree nodes,Betweenness centrality,Local reaching centrality,Label,Community
0,100355699843047465067178463041045147428005271050,2,1,1,0.0,0.005475293565702143,pH <= 5.35,0
1,928621589127927934620961952074257259595278295629,49,49,0,0.0,0.0,Class 2,0
2,1008735715616984285175406527072402270956929764431,3,1,2,0.0025593844095015057,0.0018250978552340478,moisture <= 82.29,1
3,317941571541460063651988726798590958196687947450,2,1,1,1.672800267648043e-05,0.00045627446380851194,moisture > 77.75,0
4,882921113826551691757327700518952611644113607498,2,1,1,6.691201070592172e-05,0.00045627446380851194,moisture <= 77.75,1
5,1010046219272533096104760473819206042211739377642,2,1,1,0.0,0.0036501957104680956,pH > 4.16,1
6,171982518954274878349485416184092168691833932185,35,35,0,0.0,0.0,Class 1,1
7,101808344089847205341711026940422587424002819247,2,1,1,0.0001589160254265641,0.0013688233914255358,pH > 5.41,2
8,1195054242563020476783971172209845772931465202363,23,23,0,0.0,0.0,Class 4,2
9,1023476827254154405379055664415699571984251753915,2,1,1,6.691201070592172e-05,0.00045627446380851194,moisture <= 86.51,3
10,150913633418211931633209064051558675044205003315,35,35,0,0.0,0.0,Class 3,3
11,1026042788165573799036895541827035916749590738414,2,1,1,1.672800267648043e-05,0.0009125489276170239,moisture <= 82.37,0
12,1039644001710311114305057624204376969195728974014,2,1,1,0.0,0.007756665884744702,Tit Acid <= 0.23,1
13,1040952865803721929906599721084890774852026858547,9,3,6,0.04660421545667447,1.7159584519814122,Pheno > 0.72,0
14,1308425805814366873910502507832070611603025885708,3,1,2,0.005185680829708933,0.021520945542968142,pH <= 5.17,3
15,1312310949554463399287816576824423061306594586155,6,2,4,0.018066242890598865,1.251189497510371,moisture <= 88.58,1
16,1329907479955885769404976189624453827909930603141,2,1,1,0.0,0.011406861595212796,moisture <= 89.16,0
17,14031532405571743634624912828080204254597625767,3,1,2,0.0025092004014720644,0.012775684986638334,pH > 5.17,0
18,567209310890593965756633184996901447968879846381,6,2,4,0.006323185011709602,2.21129799304904,moisture > 88.58,0
19,880906355044111715629274031211066252453008613553,4,1,3,0.015958514553362328,1.1920354846932375,moisture > 89.16,3
20,1043903249785310589747781639007621873485197433743,2,1,1,0.0,0.00228137231904256,pH > 3.96,4
21,1147257542945440298109815666246017244067397811172,18,18,0,0.0,0.0,Class 0,4
22,1047079156029689005341523092134779784460317576067,6,2,4,0.0027768484442957514,0.009353626508074494,Brix <= 10.47,0
23,1254609139350073366408358171331618191603227032344,2,1,1,8.364001338240215e-05,0.00045627446380851194,moisture > 87.96,3
24,532713744300870815677350821848934444001877176071,3,2,1,1.672800267648043e-05,0.004106470174276607,Pheno > 0.69,0
25,647291524414615663051227101926122920500217886230,2,1,1,5.018400802944129e-05,0.0009125489276170239,moisture <= 87.96,0
26,692974179782182730962353172046240081223686466110,3,2,1,1.672800267648043e-05,0.00228137231904256,Pheno <= 0.69,3
27,1050138127985302820202133187096985161603634357309,2,1,1,0.0,0.008212940348553214,pH > 4.28,1
28,1060084067161209962842478628692160995414009753795,3,1,2,0.000351288056206089,0.006615979725223423,moisture > 86.88,3
29,269231723888614229279723687375537811294992806521,5,2,3,0.0027601204416192707,0.0036501957104680956,pH <= 5.01,3
30,527059532766714304085954891916145060191909943540,3,2,1,0.0,0.00456274463808512,pH > 5.01,0
31,106371454088754143849264350724796277613485886699,2,1,1,0.0,0.007300391420936191,moisture > 82.29,1
32,1064722700211612430482514847059080720237476709767,2,1,1,0.0,0.00912548927617024,Tit Acid <= 0.25,1
33,1070714795032507544760283061226237462475556627885,3,1,2,0.0048009367681498836,1.4914018882502826,Brix > 9.25,2
34,1351945955060965088498220515028432149719863926292,12,5,7,0.02764302442288391,2.272212872543488,Tit Acid <= 0.11,2
35,227433626263115702977273694017012744327541066228,12,5,7,0.026714620274339244,1.638246400913951,Tit Acid > 0.11,3
36,1077766440587969615108921971347658648400205152291,2,1,1,3.345600535296086e-05,0.00045627446380851194,Brix > 11.65,2
37,1078664175220452826181491234246161857680321264899,3,1,2,0.002626296420207427,0.00456274463808512,Pheno <= 0.78,1
38,708307369965008590189675821508918649697763876974,2,1,1,5.018400802944129e-05,0.0018250978552340478,moisture > 88.81,1
39,977286805996686270201311206481905987913845796832,2,1,1,3.345600535296086e-05,0.00045627446380851194,moisture <= 88.81,0
40,1078718250260529169811044400086132239331939615427,2,1,1,1.672800267648043e-05,0.00228137231904256,moisture > 88.08,0
41,1084251021297852025110799230501022317851666576367,6,3,3,0.005235864837738374,0.013536142426319186,Tit Acid > 0.16,0
42,344374707049404674276662998256192058261482321044,3,1,2,0.0027768484442957514,0.0018250978552340478,Brix <= 11.1,3
43,802523795241509955998960003552105484779323386560,2,1,1,0.0,0.004106470174276607,Brix > 11.1,0
44,108695551173216811220809398532289050002057560322,8,3,5,0.017648042823686854,1.6466119923944431,pH > 5.16,0
45,124210201951521362978433460778195822768531021450,6,3,3,0.0030277684844429577,0.004106470174276607,Pheno > 0.75,3
46,469361508389853439729697629011115598507104148813,5,3,2,0.00021746403479424559,0.008669214812361726,Pheno <= 0.75,4
47,574547959522810993478881239530428912007409448452,3,1,2,0.013365674138507862,1.5362399073842279,Brix <= 10.9,0
48,948520268441144489078643971563148628499226892328,3,1,2,0.0,0.014981011561712809,Brix > 10.9,4
49,1092810479860852010962744361185020914673156703389,3,1,2,0.005720976915356306,2.070076141385217,moisture <= 85.23,3
50,1321661511126510148468737894218929275593525496686,4,3,1,3.345600535296086e-05,0.0036501957104680956,Tit Acid <= 0.1,2
51,542587181052035438973110002434304419085007660766,6,3,3,0.01942121110739378,2.4907881751496412,Tit Acid > 0.1,3
52,1097393218549485926510675082709423471387496958586,2,1,1,1.672800267648043e-05,0.00045627446380851194,pH > 5.34,3
53,1098687669563514264025770275896785710322424675602,3,1,2,0.00272666443626631,0.0036501957104680956,pH <= 4.16,4
54,110446626826307389898629859452394264952855631815,2,1,1,3.345600535296086e-05,0.00045627446380851194,Tit Acid <= 0.3,1
55,137287800202512868294706791040107241621141460475,2,1,1,0.00018400802944128471,0.0013688233914255358,Tit Acid > 0.3,4
56,1102552590753363862067286774401604289524440052770,2,1,1,5.018400802944129e-05,0.00045627446380851194,Brix > 9.03,3
57,1110286006501510599660955608137587775701142963526,3,1,2,0.0025092004014720644,0.008212940348553214,pH <= 5.14,0
58,606472261887217459912504716286461793220012175689,2,1,1,1.672800267648043e-05,0.0031939212466595836,moisture > 85.13,0
59,867891166252050599975181215235547111412275904906,2,1,1,1.672800267648043e-05,0.0009125489276170239,moisture <= 85.13,3
60,1133159116889617656789667783688475393360249653467,3,1,2,0.013616594178655069,1.221774521335449,moisture <= 87.68,3
61,14019385422964220106431955229528509600988724262,7,4,3,0.0007667001226720196,0.0036501957104680956,Tit Acid <= 0.13,0
62,947349482492510815730367502829189066919667400905,8,4,4,0.09389427902308464,1.3611811043666544,Tit Acid > 0.13,3
63,114288386783329094858692510758135355427541248708,9,3,6,0.01985613917698227,2.0880906969356148,pH <= 5.16,3
64,1221944330954297241198945957952029773803656613142,3,1,2,0.005085312813650051,0.009657809483946834,Brix <= 10.55,3
65,19891257783741809757185714212867381439689844226,3,1,2,0.009250585480093677,2.0683915382318876,Brix > 10.55,3
66,756297897021004223295909235636130446250906912491,2,1,1,6.691201070592172e-05,0.00228137231904256,moisture <= 87.16,0
67,933756729222335092793216951610122983063076054863,2,1,1,6.691201070592172e-05,0.00045627446380851194,moisture > 87.16,3
68,941244954744452374879064598878143830366660406032,3,1,2,0.0014553362328537974,2.3584077934303544,moisture <= 87.54,3
69,94515194669438306255100726188346520486372319968,2,1,1,0.0,0.0013688233914255358,moisture > 87.54,3
70,1164855885306831319184235241463983184084645723167,2,1,1,1.672800267648043e-05,0.005475293565702143,pH <= 4.54,4
71,116714911697737382047441536574520846070686499340,3,1,2,0.0066995650719304115,1.2068752887033307,pH > 4.54,0
72,1237929490392718556791145078841139784211144198794,18,7,11,0.04282089885134381,1.5963449490857693,Tit Acid <= 0.15,3
73,227367995596712800920562994603144313835373533341,17,7,10,0.11654678264748522,1.4342960610626299,Tit Acid > 0.15,0
74,1167183909342085360674118187473349155904865714208,2,1,1,0.00020073603211776515,0.00045627446380851194,moisture > 86.51,1
75,1185057046879178801075786448767209572074539141236,3,1,2,0.031498829039812645,1.69455113569587,Brix <= 12.62,2
76,220952344825236051350462729633981943946572015955,4,2,2,0.00010036801605888258,0.0027376467828510716,pH <= 4.7,4
77,858953369304300943219160058980346335087447704861,4,2,2,0.0390598862495818,1.840810555748116,pH > 4.7,2
78,1187581803421129234872707013583207512006569505258,3,1,2,0.002576112412177986,0.00456274463808512,Brix > 9.7,3
79,402551501852144362591499086205357905265844403402,2,1,1,3.345600535296086e-05,0.00045627446380851194,Pheno > 0.74,0
80,850680869277507842791030455333102941280107573886,2,1,1,3.345600535296086e-05,0.0018250978552340478,Pheno <= 0.74,3
81,1200230442900566009235442248446334046045517526,3,1,2,0.007878889260622282,1.6500354868879403,moisture > 88.49,0
82,704362326170157818240896235218517135228275068157,2,1,1,0.0,0.005475293565702143,moisture <= 89.67,0
83,716241450914435212182101260787324804766153660181,3,1,2,0.00894948143191703,1.791549933418543,moisture > 89.67,2
84,1202281202334859649737464243089883719203118393624,2,1,1,0.0,0.00958176373997875,moisture <= 88.03,4
85,1208199532003260704580883667179978148803167350089,3,1,2,0.001789896286383406,1.654462793692554,moisture > 84.12,1
86,1211846329451821365990554836744104379479915130951,3,1,2,3.345600535296086e-05,0.020076076407574524,pH <= 4.28,4
87,1317131137490315402024263102743181549566993569198,2,1,1,1.672800267648043e-05,0.0018250978552340478,Brix <= 10.68,1
88,1422967542425949721261238579709952580993794609712,2,1,1,1.672800267648043e-05,0.008212940348553214,Brix > 10.68,4
89,1217802002027660884953098701453035691707860350981,3,1,2,0.00013382402141184343,0.0027376467828510716,moisture > 87.84,1
90,1410003837021284485887033207243894734280530728651,2,1,1,5.018400802944129e-05,0.0009125489276170239,moisture <= 88.59,1
91,826578605362370356601600883514144447637327657066,2,1,1,5.018400802944129e-05,0.00045627446380851194,moisture > 88.59,4
92,1220406208029421398891215352067484920853928295930,5,1,4,0.00234192037470726,2.490786364536692,Pheno > 0.62,3
93,1427828628260900981801428293654733815387871495302,6,3,3,0.005679156908665106,1.2393256372061683,Brix > 11.53,0
94,505662032645117586105020132832693601065137912470,9,3,6,0.012897290063566411,1.3954095267006636,Brix <= 11.53,0
95,642112573656807165703313015619896940450767607790,6,2,4,0.008732017397122784,2.668906648161245,Tit Acid <= 0.18,3
96,999449005863449650043698603557860460414697697202,6,2,4,0.001639344262295082,1.8939882404109472,Tit Acid > 0.18,1
97,410379081296456089389439250464324545207920013865,2,1,1,8.364001338240215e-05,0.00045627446380851194,Brix <= 9.7,1
98,1226999407028174264856564375386384119756490121214,3,1,2,0.002576112412177986,0.0018250978552340478,pH > 5.35,2
99,306377502886819632236539765984449360077875049629,2,1,1,5.018400802944129e-05,0.00045627446380851194,Brix <= 9.03,2
100,1233198855909382054836554163560023233305861086389,4,1,3,0.003077952492472399,1.7039882453888058,Pheno <= 0.62,2
101,1332817049989096526625739202212078353018225607016,2,1,1,0.0,0.0013688233914255358,moisture <= 84.66,2
102,1419672045835053177656061389410347597700670946936,2,1,1,0.0,0.0036501957104680956,moisture > 84.66,3
103,201652953103342019199086917760886428083210198503,3,1,2,0.004014720642355303,0.023498134886138364,Brix > 10.7,3
104,414546368116635972257913228794527802843288302412,3,1,2,0.03218467714954835,1.6791194245856114,Brix <= 10.7,0
105,539841963763980928303120942267934660259153369307,3,2,1,3.345600535296086e-05,0.0027376467828510716,pH > 5.1,2
106,894406717605448330614352030725481623211153227930,3,2,1,3.345600535296086e-05,0.0018250978552340478,pH <= 5.1,3
107,1419060244117965495412029413417760007259458564683,2,1,1,0.00013382402141184343,0.00045627446380851194,Brix > 12.85,1
108,454790473848408353201751758466431519326046225362,2,1,1,0.00018400802944128471,0.0009125489276170239,Brix <= 12.85,4
109,1250059311300753794030521829379652543833568345626,3,1,2,0.002459016393442623,2.1531318886431974,moisture > 86.35,3
110,478988701995746220836729620311416045687869066757,3,1,2,0.00351288056206089,2.16746137835677,Pheno <= 0.8,3
111,937787711282178832864130665432839185535877783171,2,1,1,1.672800267648043e-05,0.0018250978552340478,Pheno > 0.8,0
112,1267223687777369789844656014428253412555264842238,3,1,2,0.0050016728002676486,2.5892216709211096,Brix > 11.03,3
113,1294092558534500641731851223402440377639362886552,13,5,8,0.03288725326196052,2.627012702146755,Pheno <= 0.77,3
114,837370564306014830643982857390690332587885059971,10,5,5,0.0029775844764135164,0.01186313605902131,Pheno > 0.77,0
115,1276810453078600040270949478387573991456066005105,3,2,1,8.364001338240215e-05,0.0018250978552340478,Pheno <= 0.66,0
116,1281273895387046191760352024421035690157442365739,3,1,2,0.0030110404817664774,2.146329029604269,moisture <= 88.55,3
117,1420855393752826397476723276676391429574104930872,3,1,2,0.004064904650384745,2.0361850666320036,Pheno <= 0.81,3
118,946469583164485345996914984787775396258236729112,2,1,1,1.672800267648043e-05,0.00228137231904256,Pheno > 0.81,0
119,1292156175655789376150693168663733282100804338917,3,1,2,0.010639009702241553,1.3097342188106773,Brix > 10.75,0
120,431500440665982291877861151163819974354623898398,7,2,5,0.026212780194044834,3.1059562376309766,Tit Acid <= 0.26,3
121,494127393420143926044921388078061355092756508432,3,2,1,0.0,0.02326999765423411,Tit Acid > 0.26,4
122,622598769667804494137629575765384734315163051315,3,1,2,0.0038056206088992977,0.00456274463808512,pH <= 5.34,1
123,763950697541158696363668447456846400874782411362,2,1,1,2.5092004014720644e-05,0.0018250978552340478,Brix > 11.72,0
124,929991558533201463690147621459319073435429710754,3,1,2,0.00234192037470726,0.007984803116648958,Brix <= 11.72,3
125,1450270867430735247459946524454813490581917250745,3,1,2,0.0027935764469722317,0.011330815851244713,moisture <= 88.08,3
126,1334397803982614334162389130667683854243451195325,3,1,2,8.364001338240215e-05,1.8518377280088882,moisture <= 87.28,1
127,20443890347911038642410738347573019158895268679,3,1,2,0.005687520910003346,1.2930930562336225,moisture > 87.28,0
128,526047352448732854443680809168250965427631523486,3,1,2,0.0025426564068250254,0.00456274463808512,pH <= 4.98,0
129,825792580619614131751020977051041803762036359722,3,1,2,0.008347273335563734,1.8198709663698414,pH > 4.98,3
130,384165568604620773602991426913274488186991046821,8,3,5,0.05381398461023754,1.8956568987748346,Tit Acid <= 0.28,1
131,665763256441369002694541083156400242042163903310,8,3,5,0.005118768819003011,0.014144508378063868,Tit Acid > 0.28,4
132,1351790565781538588069137276152767980617598773955,2,1,1,0.0,0.004106470174276607,moisture > 85.23,2
133,1747132756190080726694698293394103700627759963,2,1,1,0.0,0.0031939212466595836,Brix > 9.93,2
134,176674819211903920805174053136212153900221587233,3,1,2,0.002651388424222148,0.00456274463808512,Brix <= 9.93,2
135,692230003551773387974254284960557962532377614617,2,1,1,0.0,0.004106470174276607,moisture > 85.31,2
136,820642040601351691576170655480463712641262059957,3,1,2,0.009033121445299433,2.027899657449683,moisture <= 85.31,2
137,1365155039725429132679548442176646454137333102322,2,1,1,0.0,0.007756665884744702,moisture <= 86.35,0
138,1373347432538866619505116869199797637013813938826,2,1,1,0.0006691201070592172,0.00045627446380851194,pH <= 4.19,4
139,1373420230415465564614592954188166067206038571386,3,1,2,0.0,1.2239249996327992,pH <= 5.39,0
140,1440335382918687438535224440716847939872691334081,6,2,4,0.008614921378387421,0.02030421363947878,Pheno <= 0.76,0
141,708974994663940473356047250801743764720458270635,6,2,4,0.0132206981153117,1.1791373148685895,Pheno > 0.76,0
142,1375456881799729951521866427476070429249136782258,6,2,4,0.011609233857477417,2.0541465813522226,Pheno <= 0.83,3
143,1441655350341890941614520753917652373824477167080,9,3,6,0.06480428236868518,2.276396195007502,Tit Acid <= 0.16,3
144,1383045789014029471710781731961807727090016907641,2,1,1,0.0001589160254265641,0.00045627446380851194,pH > 4.19,1
145,1386691901693956780169467586885890447209598951478,9,4,5,0.06284710605553698,2.42530844412204,Tit Acid <= 0.19,3
146,47635510756424328729794967520824764353044331683,10,2,8,0.02932418869187019,2.2571689504117645,pH > 4.85,3
147,5771222888430697625926571315532113256585960605,7,2,5,0.02181331549013048,2.6093276895490196,pH <= 4.85,1
148,153190256752309298641849943950418323697184319165,2,1,1,1.672800267648043e-05,0.00045627446380851194,moisture > 89.35,3
149,868946321800397981410011141217634304658769961352,2,1,1,1.672800267648043e-05,0.005931568029510655,moisture <= 89.35,0
150,1405245601027660786125741477698000295615911050563,4,2,2,0.00011430801828928293,0.0031939212466595836,Pheno > 0.66,1
151,1405274910472303373621727438174058522403111208261,3,1,2,0.0068752091000334565,1.8848707216302532,pH <= 5.2,3
152,165644917979433045096778224233875896118673456949,8,3,5,0.0553864168618267,2.018506476012513,Brix > 10.47,3
153,1405395433493292145183461183700747787876089761855,3,1,2,0.0025092004014720644,0.01825097855234048,pH <= 4.25,4
154,673794176245197217307081310071062228669787260547,2,1,1,1.672800267648043e-05,0.008669214812361726,Brix > 10.38,4
155,970244233178621150864039654935840188579193162108,2,1,1,1.672800267648043e-05,0.00045627446380851194,Brix <= 10.38,1
156,1428658052013333682747391643778840960704983020503,2,1,1,1.672800267648043e-05,0.0009125489276170239,Tit Acid <= 0.36,1
157,382306255640768803407450227941569918411826841725,2,1,1,0.0,0.00228137231904256,Brix > 11.62,0
158,992276951130140076069564900606041387590736103754,2,1,1,0.0012713282034125127,0.0036501957104680956,Brix <= 11.62,0
159,1441189812431330585781218556711162470315886855828,2,1,1,6.691201070592172e-05,0.0009125489276170239,Brix > 10.8,0
160,233389824999274977386666943139025198274661939050,2,1,1,0.0,0.0018250978552340478,moisture > 86.56,3
161,480973683640555062597960284928378118245170177048,3,1,2,0.003579792572766812,0.009733855227914921,moisture <= 86.56,2
162,14442704175834311673809285687173178578897551221,2,1,1,5.018400802944129e-05,0.0009125489276170239,moisture > 89.62,0
163,1452257316934691433684555933573947300980215553269,2,1,1,0.0,0.0018250978552340478,moisture <= 86.88,3
164,1453111610836043485603872587149067601606349671873,2,1,1,3.345600535296086e-05,0.00045627446380851194,moisture <= 81.58,0
165,1455830194495073189631966781357784705407217818656,2,1,1,1.672800267648043e-05,0.00045627446380851194,Brix <= 9.65,3
166,1459505541307075317069583903840023895269513889914,5,2,3,0.002643024422883908,0.005475293565702143,Pheno <= 0.7,2
167,521715610441294927518937479846970148498395371549,2,1,1,0.00010036801605888258,0.0009125489276170239,Brix <= 11.43,2
168,985159174247860258406427835362282688395764253852,2,1,1,3.345600535296086e-05,0.0009125489276170239,Brix > 11.43,3
169,146662789408622558997772424169412165014127628606,3,1,2,0.005102040816326531,0.011330815851244713,Brix <= 10.2,1
170,41417030911434338004125230269439804259879445302,2,1,1,0.0,0.0018250978552340478,Pheno > 0.78,0
171,945983268971432222548859207615769581540823239463,5,2,3,0.002626296420207427,0.007756665884744702,Pheno > 0.7,3
172,16769566651221792157231450049135750503234403831,3,1,2,0.00010036801605888258,0.02000003066360644,Tit Acid > 0.25,4
173,190261406027496846769744968603813117614724013280,2,1,1,0.0,0.007756665884744702,moisture <= 87.84,4
174,303427651036728708663818405774914844390855506685,2,1,1,1.672800267648043e-05,0.0009125489276170239,pH <= 5.41,0
175,177267499210149510724253963525281511412675617616,6,0,6,0.0,2.2436833240867973,pH > 4.75,3
176,314481329406331221346824442324578186096521671941,3,1,2,0.0012713282034125127,1.4624283939579708,pH > 5.29,2
177,879777753611004235437037181589738421603931041991,3,1,2,0.00010036801605888258,2.08657712959958,pH <= 5.29,0
178,180087590449994414434638415576357070068029946541,2,1,1,3.345600535296086e-05,0.00045627446380851194,Brix > 13.12,0
179,188380948886476719573524477793633683606238040340,2,1,1,1.672800267648043e-05,0.00045627446380851194,pH > 5.14,3
180,497763542274658046246028816444402973884179748326,3,2,1,3.345600535296086e-05,0.0013688233914255358,Pheno > 0.83,3
181,209290609112958771186681508504118851516004531847,2,1,1,1.672800267648043e-05,0.0031939212466595836,moisture <= 86.91,1
182,37775716639446480443771936493018162492062706461,10,4,6,0.05441619270659084,1.7290007440274453,Tit Acid > 0.19,1
183,747423452227744247161295534790989887946002677415,3,1,2,0.0033037805286048848,0.0018250978552340478,Brix <= 10.72,4
184,859937142169726300085497970880016369278523345795,3,1,2,0.002406044384967102,0.004106470174276607,Brix > 11.05,0
185,952313422186425994786064188240471309864615073355,2,1,1,0.0,0.00228137231904256,Brix > 10.72,1
186,73042002829014946871968702197963386318846964912,3,1,2,0.007527601204416193,0.024182546581851132,moisture > 88.55,1
187,893931918085720507244247615538062186675227880,2,1,1,0.0,0.004106470174276607,moisture <= 84.12,0
188,250383666050288555922939422873386412387888164590,3,1,2,0.011492137838742054,1.171392221116939,moisture <= 89.62,0
189,275672428306700848789239444899634693368241626742,3,1,2,0.012546002007360321,1.1574098999767197,Brix > 9.65,0
190,254893065517892840005300634273584051593270979037,2,1,1,0.0,0.0013688233914255358,Brix > 11.28,3
191,264180769172240921923099009387695914077031880466,2,1,1,0.0001756440281030445,0.00045627446380851194,pH <= 4.86,1
192,277392185426870536829681764470138299155325539424,2,1,1,0.0,0.0009125489276170239,Brix <= 10.8,3
193,272977833151769436873634510482870044006295702260,2,1,1,0.0,0.0027376467828510716,Brix <= 11.22,0
194,940350166092675029613861939749538763040688165718,2,1,1,0.0,0.0027376467828510716,moisture > 87.68,0
195,278294357183925540075974209286894632605115984545,3,1,2,0.007209769153563065,1.4948029436186072,moisture <= 90.17,0
196,363055097658377278005929267836332155594581026628,2,1,1,5.018400802944129e-05,0.005931568029510655,Brix <= 10.75,0
197,284206613161054309682069943008232583179454839881,3,1,2,0.0,2.078215580977238,moisture <= 88.49,3
198,763212543587750217808106594112871041545025736785,5,2,3,0.008882569421211108,2.033080678296558,Tit Acid > 0.12,3
199,775650655566268222195963750769541160664287144256,5,2,3,0.004717296754767481,1.8225091066762913,Tit Acid <= 0.12,2
200,313939282134011473969488680274167618177754315821,2,1,1,6.691201070592172e-05,0.00045627446380851194,Tit Acid > 0.36,4
201,510370834311025835074897415063219541371286131486,2,1,1,1.672800267648043e-05,0.0031939212466595836,Brix <= 9.25,2
202,314857879696376171423608953820670847835654884757,2,0,2,0.0,2.139250428140606,pH > 4.73,3
203,363527198380171677164642678006029696042250523634,2,1,1,0.0,0.0027376467828510716,moisture <= 88.35,3
204,516601140442069092777768951925603503757731753522,6,2,4,0.05162261625961861,2.0366110861332403,pH <= 5.21,3
205,556056145676242252196935790480711865714256718197,3,1,2,0.013131482101037137,1.5815726065703226,moisture <= 84.99,1
206,609655441806685391040905382276868544877293772511,2,1,1,0.0,0.008212940348553214,moisture > 84.99,1
207,7502286575422847517785813269994352158580699271,3,2,1,0.0,0.005475293565702143,pH > 5.21,0
208,624005623655726474188392415263575322370572793900,8,3,5,0.016912010705921715,1.4980370604727935,Pheno <= 0.72,0
209,427126028839433250346413229071032180560802580904,3,1,2,0.0036968885915021747,1.82640240186569,Pheno > 0.6,0
210,979770619769858128234174557901858574279628382643,2,1,1,3.345600535296086e-05,0.00045627446380851194,moisture > 90.17,1
211,90554010616762234662496603681414451697237230950,3,1,2,0.002609568417530947,0.010038038203787262,moisture > 81.58,1
212,433642784130098273252973182946829464603765446865,3,1,2,0.0025426564068250254,0.0036501957104680956,pH > 5.2,0
213,528566363778781775621158712241864824836897742885,2,1,1,3.345600535296086e-05,0.0013688233914255358,Brix <= 11.65,0
214,435202031619377897596867520115245422957439936887,2,1,1,0.0,0.0013688233914255358,Brix > 12.62,1
215,450137369394240904356265189787880609614373502474,2,1,1,0.0013047842087654735,0.0018250978552340478,Brix > 9.58,1
216,857607319684230108814194832161409755184334901663,2,1,1,5.018400802944129e-05,0.0009125489276170239,moisture > 88.94,1
217,452904644816443076163971148700177337687315851572,2,1,1,4.1820006691201076e-05,0.0009125489276170239,Brix <= 9.58,0
218,461351175668361397396959260669952822309859886820,3,1,2,0.0011375041820006692,0.005019019101893631,moisture > 82.37,2
219,470883890755101777036665426309530769805441851943,2,1,1,3.345600535296086e-05,0.0013688233914255358,moisture <= 87.21,0
220,984571787725314973554677945454022515297863304581,3,1,2,0.0032535965205754435,1.3579790708142743,Brix <= 11.28,0
221,514308004345302084856069340481921906503689782945,3,1,2,0.004340916694546671,1.4302129477954295,pH > 5.39,2
222,980803654742893966226846922953986193663478036153,2,1,1,3.345600535296086e-05,0.0009125489276170239,moisture > 87.21,1
223,568484349403032706442811090722432144818001088423,6,2,4,0.00038474406155904986,0.037794734752138404,pH <= 4.32,4
224,585831330631376020196651220005217173751910922427,3,1,2,0.00015055202408832387,0.0027376467828510716,moisture > 88.03,1
225,665349927789854546665190254614539114508329105543,3,1,2,0.0075443292070926735,0.04726242987616503,pH > 4.25,1
226,993598645401710847477252614412509615077137993235,3,1,2,0.005168952827032453,0.013384050938383015,Brix <= 11.03,1
227,597240793788279097482678786121035081124008541581,2,1,1,6.412401025984164e-05,0.00045627446380851194,pH > 4.86,3
228,623405411197778898714952083352355935308706710539,2,1,1,0.000117096018735363,0.0018250978552340478,moisture > 86.91,4
229,636091658639320017876099791131110476351290392097,2,1,1,1.672800267648043e-05,0.0009125489276170239,moisture > 87.78,1
230,644675602832081649327117396129484128393056484155,2,1,1,0.0,0.005931568029510655,moisture <= 87.78,4
231,950777180855255984755872747437635027007930381761,3,1,2,0.005118768819003011,0.02288976893439368,Brix <= 13.12,1
232,832773610056439029892754125124439324367450502547,2,1,1,1.672800267648043e-05,0.0009125489276170239,pH <= 3.96,1
233,672332599721112324355867062173889692788689330655,2,0,2,0.0,2.207634441852266,Brix > 11.6,1
234,679457994161468121604690233924775229118954641934,5,2,3,0.006908665105386417,2.2124411836787825,pH > 4.32,1
235,943830203843581604646810821449307790172120745568,2,1,1,1.672800267648043e-05,0.0031939212466595836,Brix > 10.2,0
236,730699573538352139692191826491930980328647852283,2,0,2,0.0,2.169169871471757,pH <= 4.73,4
237,738760784115287950683012939167376161343781682445,2,0,2,0.0,2.878107255308619,Brix <= 11.6,3
238,759783886644566511118470111056334794848645516977,2,1,1,0.00010036801605888258,0.0009125489276170239,moisture > 88.35,0
239,789273779712049564769444004041627008717039852509,2,1,1,1.672800267648043e-05,0.0018250978552340478,moisture > 85.15,0
240,818300426017039898302815959957484483327736126221,3,1,2,0.002643024422883908,0.00456274463808512,Tit Acid > 0.23,4
241,850278928786610505626500046722420659750738748426,2,1,1,5.018400802944129e-05,0.0009125489276170239,Brix > 12.2,1
242,934897931545540742699033276090586194972302902861,2,1,1,5.018400802944129e-05,0.0013688233914255358,Brix <= 12.2,4
243,922311927435954455015399968817795198456525739825,2,1,1,0.00025092004014720643,0.00045627446380851194,Brix > 11.22,3
244,982119225243198413857918285177710587335623039998,2,1,1,1.672800267648043e-05,0.0013688233914255358,Pheno <= 0.6,2
245,953013916229408958655391420495312068437993458202,6,0,6,0.0,2.9884048253658166,pH <= 4.75,4
