,Node,Degree,In degree nodes,Out degree nodes,Betweenness centrality,Local reaching centrality,Label,Community
0,1040952865803721929906599721084890774852026858547,6,4,2,0.00047603935258648045,0.01728831015964099,Pheno > 0.72,0
1,171982518954274878349485416184092168691833932185,17,17,0,0.0,0.0,Class 1,1
2,928621589127927934620961952074257259595278295629,29,29,0,0.0,0.0,Class 2,0
3,1043903249785310589747781639007621873485197433743,2,1,1,5.289326139849783e-05,0.007858322799836814,pH > 3.96,1
4,1047079156029689005341523092134779784460317576067,3,1,2,0.0030149158997143763,1.1634901765391725,Brix <= 10.47,0
5,122445604033908938473078190630948358698133432926,3,1,2,0.0023273035015339044,0.020955527466231503,Brix <= 8.88,2
6,158059194345770793863619625413686121428844757978,3,1,2,0.004654607003067809,1.223219042905646,Brix > 8.88,0
7,1060084067161209962842478628692160995414009753795,3,1,2,0.0007405056595789696,0.033921760085962246,moisture > 86.88,0
8,624005623655726474188392415263575322370572793900,8,4,4,0.003385168729503861,0.01728831015964099,Pheno <= 0.72,2
9,1060955779595425748725945873660970247599097926850,2,1,1,0.00013223315349624457,0.0007858322799836814,Brix <= 10.3,0
10,1062954839499741435099281870671573353624379985300,2,1,1,0.00031735956839098697,0.0007858322799836814,moisture <= 73.5,3
11,150913633418211931633209064051558675044205003315,15,15,0,0.0,0.0,Class 3,3
12,1070273689123157126391876039198756885761013090596,3,1,2,0.0002115730455939913,0.01100165191977154,pH <= 3.9,4
13,478978841060079567412714578692729068041119193452,2,1,1,0.00010578652279699566,0.004714993679902088,Tit Acid > 0.34,4
14,66720490521188455368693219024132734792714896895,2,1,1,0.00010578652279699566,0.0007858322799836814,Tit Acid <= 0.34,1
15,1072133880569573387818734585571448733401927403419,3,1,2,0.0002115730455939913,0.006286658239869451,Pheno <= 0.63,4
16,1220406208029421398891215352067484920853928295930,2,1,1,0.00010578652279699566,0.0007858322799836814,Pheno > 0.62,1
17,1233198855909382054836554163560023233305861086389,2,1,1,0.00010578652279699566,0.002357496839951044,Pheno <= 0.62,4
18,1075813379524996807643429599466753799092299370004,3,1,2,0.014968792975774886,0.9829997818990315,Brix > 10.6,0
19,1098185664989343046012160366509114351270866542056,2,1,1,0.00010578652279699566,0.0015716645599673628,Tit Acid > 0.14,0
20,905638127712786336374745985074473946082791119647,3,1,2,0.018830001057865225,1.113040991517045,Tit Acid <= 0.14,0
21,1078664175220452826181491234246161857680321264899,3,1,2,0.00047603935258648045,0.012573316479738902,Pheno <= 0.78,0
22,1185884278337992742856356075127001292993529548115,2,1,1,5.289326139849783e-05,0.00550082595988577,Pheno > 0.68,0
23,401849052094181080436076126418024594358650184652,2,1,1,0.0002115730455939913,0.0007858322799836814,Pheno <= 0.68,3
24,1078718250260529169811044400086132239331939615427,2,1,1,0.00013223315349624457,0.003929161399918407,moisture > 88.08,0
25,108695551173216811220809398532289050002057560322,3,1,2,0.005183539617052787,1.182127215290173,pH > 5.16,0
26,1351945955060965088498220515028432149719863926292,6,3,3,0.004284354173278324,0.05566311983217743,Tit Acid <= 0.11,2
27,227433626263115702977273694017012744327541066228,9,3,6,0.03432772664762509,1.08726583447822,Tit Acid > 0.11,0
28,1089411312405778075857150353731495107904700052823,2,1,1,5.289326139849783e-05,0.002357496839951044,pH <= 5.32,2
29,1195054242563020476783971172209845772931465202363,9,9,0,0.0,0.0,Class 4,2
30,1089417730565464906771328301463084496248388456977,2,1,1,0.0,0.0015716645599673628,moisture > 88.24,0
31,1133159116889617656789667783688475393360249653467,3,1,2,0.002168623717338411,0.01100165191977154,moisture <= 87.68,3
32,231181347083149241591051667437200970404733148699,2,1,1,0.00031735956839098697,0.0031433291199347256,Brix > 10.88,3
33,678579799782929757328525100603297462527014574466,2,1,1,5.289326139849783e-05,0.002357496839951044,Brix <= 10.88,0
34,114288386783329094858692510758135355427541248708,3,1,2,0.00047603935258648045,0.08251238939828653,pH <= 5.16,0
35,17602321598437820260191588653395954663151122276,2,1,1,2.6446630699248914e-05,0.009429987359804177,Brix > 11.24,0
36,34329644815662990933072560594117088490383573434,3,1,2,0.0007669522902782186,0.0402084183258317,Brix <= 11.24,0
37,1151684139108188992227777924983826154453017451998,5,2,3,0.0025388765471278957,0.01728831015964099,Pheno > 0.67,1
38,637876484834474046559204233866853224739834829672,2,1,1,0.00026446630699248914,0.0007858322799836814,moisture <= 85.15,3
39,789273779712049564769444004041627008717039852509,2,1,1,0.00015867978419549348,0.0015716645599673628,moisture > 85.15,0
40,1147257542945440298109815666246017244067397811172,11,11,0,0.0,0.0,Class 0,4
41,1237265994102648826715151826126075249469806378295,2,1,1,0.00010578652279699566,0.0007858322799836814,Brix <= 9.28,3
42,1237929490392718556791145078841139784211144198794,5,2,3,0.0011636517507669522,0.08473891419157364,Tit Acid <= 0.15,3
43,1294092558534500641731851223402440377639362886552,4,2,2,0.00031735956839098697,0.020431639279575715,Pheno <= 0.77,3
44,837370564306014830643982857390690332587885059971,5,2,3,0.004072781127684333,0.030254542779371736,Pheno > 0.77,0
45,1250059311300753794030521829379652543833568345626,2,1,1,0.00010578652279699566,0.0007858322799836814,moisture > 86.35,3
46,1268506014654445549021678142540716813522721295938,2,1,1,5.289326139849783e-05,0.01178748419975522,moisture > 73.5,1
47,1268834994066267126714212531962537133291228424484,5,2,3,0.0020099439331429172,0.02278913611952676,Pheno > 0.73,0
48,1450270867430735247459946524454813490581917250745,2,1,1,5.289326139849783e-05,0.00550082595988577,moisture <= 88.08,3
49,1276810453078600040270949478387573991456066005105,3,2,1,0.00015867978419549348,0.01100165191977154,Pheno <= 0.66,0
50,1308425805814366873910502507832070611603025885708,3,1,2,0.0006347191367819739,0.11643414948424878,pH <= 5.17,0
51,520408378444148052535090774918801091096096873386,3,1,2,0.0004231460911879826,0.01728831015964099,pH <= 5.0,0
52,866219661844517520440105737257897458358104236613,3,1,2,0.0006347191367819739,0.06011616941875162,pH > 5.0,0
53,1334524575890684512407439796608446613617630066170,3,1,2,0.0014810113191579392,0.01100165191977154,Brix <= 9.22,2
54,1429004990737635021957141488797816078065197372132,2,1,1,0.00010578652279699566,0.0015716645599673628,moisture <= 86.9,0
55,741073548762277825889896492671873062153039043854,2,1,1,0.00010578652279699566,0.003929161399918407,moisture > 86.9,2
56,133664078430574839751237706315749415450747853595,3,1,2,0.0013223315349624458,0.020431639279575715,Brix <= 10.6,0
57,153190256752309298641849943950418323697184319165,2,1,1,0.00010578652279699566,0.002357496839951044,moisture > 89.35,3
58,868946321800397981410011141217634304658769961352,2,1,1,5.289326139849783e-05,0.007858322799836814,moisture <= 89.35,0
59,1365155039725429132679548442176646454137333102322,3,1,2,0.005765365492436263,0.031040375059355415,moisture <= 86.35,4
60,341697432501618660556921926132231886294070036119,5,2,3,0.0030149158997143763,0.014144981039706263,Pheno <= 0.67,4
61,1382519916745655442219420198833404777799419783607,2,1,1,0.0002115730455939913,0.0007858322799836814,Brix > 13.1,0
62,1386691901693956780169467586885890447209598951478,3,1,2,0.0040198878662858345,0.014406925133034158,Tit Acid <= 0.19,0
63,655149410276079418899607381024674837220793393243,3,1,2,0.0023273035015339044,0.0031433291199347256,Brix <= 10.1,0
64,838332085655842018555639865542533016576610136328,2,1,1,0.0,0.004714993679902088,Brix > 10.1,0
65,1391436089974438774109670874224736679839775700271,5,2,3,0.0016925843647519305,0.04544730019238957,Pheno <= 0.73,1
66,1405245601027660786125741477698000295615911050563,5,2,3,0.0028562361155188825,0.026718297519445166,Pheno > 0.66,1
67,14019385422964220106431955229528509600988724262,3,1,2,0.0031207024225113717,0.013621092853050479,Tit Acid <= 0.13,2
68,495847478012478370171945947708969305681225052120,3,1,2,0.0016925843647519305,0.006286658239869451,moisture > 84.6,2
69,532379912206672231384283986128911734636605688041,2,1,1,0.00015867978419549348,0.0015716645599673628,moisture <= 84.6,2
70,14031532405571743634624912828080204254597625767,3,1,2,0.00026446630699248914,0.07033198905853949,pH > 5.17,0
71,801502814268506334015551941594151870712294977156,2,1,1,5.289326139849783e-05,0.00550082595988577,pH <= 5.02,0
72,922557673983334858491183140850873428189492698860,2,1,1,0.0005818258753834761,0.0007858322799836814,pH > 5.02,3
73,1405274910472303373621727438174058522403111208261,3,1,2,0.0,0.1008484759312391,pH <= 5.2,1
74,1405395433493292145183461183700747787876089761855,2,0,2,0.0,0.03457662031928198,pH <= 4.25,4
75,315335336196243816662376563521226888334928581913,2,1,1,0.0,0.012573316479738902,Pheno > 0.63,4
76,1410003837021284485887033207243894734280530728651,3,1,2,0.005712472231037765,0.28139157122825187,moisture <= 88.59,0
77,947349482492510815730367502829189066919667400905,3,1,2,0.0030678091611128742,0.19905131651986652,Tit Acid > 0.13,0
78,1419060244117965495412029413417760007259458564683,3,1,2,0.0015867978419549348,0.009429987359804177,Brix > 12.85,0
79,1459505541307075317069583903840023895269513889914,2,1,1,0.00010578652279699566,0.0031433291199347256,Pheno <= 0.7,0
80,945983268971432222548859207615769581540823239463,2,1,1,0.00010578652279699566,0.0015716645599673628,Pheno > 0.7,1
81,1427828628260900981801428293654733815387871495302,2,1,1,0.00010578652279699566,0.003929161399918407,Brix > 11.53,0
82,1439157627400264411376365335601922955910930314266,2,1,1,0.0,0.012573316479738902,Tit Acid > 0.29,4
83,1440335382918687438535224440716847939872691334081,4,2,2,0.0002115730455939913,0.007072490519853132,Pheno <= 0.76,0
84,1452257316934691433684555933573947300980215553269,2,1,1,0.0,0.007072490519853132,moisture <= 86.88,3
85,1458924405464063515228681003248175979732942947901,3,1,2,0.009362107267534116,0.13108992150594445,Pheno <= 0.84,4
86,743720505332674453316309921369419980175745439591,3,1,2,0.0019041574103459218,0.012573316479738902,moisture <= 86.07,4
87,979766952529987151909249490708636929474398446830,3,1,2,0.006611657674812229,0.0806787807449913,moisture > 86.07,4
88,147860641729304468009300889158500163508655895047,2,0,2,0.0,0.03339787189930646,Tit Acid > 0.27,4
89,30286104599264233493709715352101578886395963500,2,1,1,0.0,0.008644155079820495,pH > 3.9,4
90,708974994663940473356047250801743764720458270635,5,2,3,0.03242356923727917,1.3738827367855175,Pheno > 0.76,0
91,165644917979433045096778224233875896118673456949,3,1,2,0.0050777530942557915,0.3825291211767707,Brix > 10.47,0
92,826578605362370356601600883514144447637327657066,2,1,1,5.289326139849783e-05,0.004714993679902088,moisture > 88.59,0
93,177267499210149510724253963525281511412675617616,2,0,2,0.0,1.540715224218765,pH > 4.75,0
94,207132805240402552305841715615295538047547474473,3,1,2,0.0022744102401354065,0.025146632959477805,Brix <= 13.1,1
95,21509790793552887966022874806460654910029089193,2,1,1,0.00010578652279699566,0.00550082595988577,Brix > 11.08,0
96,227367995596712800920562994603144313835373533341,6,2,4,0.014651433407383898,0.1038608330045099,Tit Acid > 0.15,0
97,264180769172240921923099009387695914077031880466,2,1,1,0.0002115730455939913,0.0015716645599673628,pH <= 4.86,1
98,505662032645117586105020132832693601065137912470,2,1,1,0.0050777530942557915,0.039160641952520114,Brix <= 11.53,0
99,597240793788279097482678786121035081124008541581,3,1,2,0.007034803766000211,0.044203065749082074,pH > 4.86,4
100,245684303784715268847019968464377942558661637315,3,1,2,0.0009520787051729609,0.06666477175194896,Pheno > 0.59,1
101,282661852526184494594935425846587408324666447561,3,1,2,0.0008462921823759652,0.022527192026198867,moisture <= 82.23,0
102,292567357245594367231950776931957522741924772421,2,1,1,5.289326139849783e-05,0.004714993679902088,Brix > 10.3,3
103,348892617720928893221806505583466033746564545815,2,1,1,0.00031735956839098697,0.0007858322799836814,pH <= 4.12,1
104,769354475543802779612776786220691121643987182460,2,1,1,0.0004231460911879826,0.004714993679902088,pH > 4.12,4
105,41417030911434338004125230269439804259879445302,3,1,2,0.0003966994604887337,0.01100165191977154,Pheno > 0.78,3
106,347375965275278585588966897722559032737374910735,2,1,1,0.0005289326139849783,0.0015716645599673628,moisture <= 88.24,3
107,359766152346022003514518626050177153554053961423,2,1,1,0.00010578652279699566,0.0031433291199347256,Brix <= 11.08,1
108,384165568604620773602991426913274488186991046821,2,1,1,0.00010578652279699566,0.0031433291199347256,Tit Acid <= 0.28,1
109,427126028839433250346413229071032180560802580904,3,1,2,0.007616629641383687,0.3953915116737893,Pheno > 0.6,1
110,703078683014261885336730977111454811685834428927,3,1,2,0.005818258753834761,0.28991972249531284,Brix > 9.22,1
111,428337588300963676283958377694182998226752112550,3,1,2,0.0006347191367819739,0.12435795830741758,Tit Acid <= 0.29,1
112,435639610782896619166063496621213255249377764557,2,1,1,0.00010578652279699566,0.0007858322799836814,Pheno <= 0.59,4
113,433642784130098273252973182946829464603765446865,3,1,2,0.004231460911879826,0.06614088356529317,pH > 5.2,0
114,454790473848408353201751758466431519326046225362,3,1,2,0.010049719665714588,0.19846194230987874,Brix <= 12.85,4
115,765592453115146640633038007468437610469124266623,2,1,1,5.289326139849783e-05,0.0007858322799836814,Pheno > 0.84,1
116,47635510756424328729794967520824764353044331683,7,2,5,0.024013540674918014,1.6701017044446655,pH > 4.85,0
117,982119225243198413857918285177710587335623039998,2,1,1,0.00015867978419549348,0.004714993679902088,Pheno <= 0.6,2
118,705007010748207944861930332260385564058444244896,2,1,1,0.00015867978419549348,0.0007858322799836814,pH > 5.32,0
119,984571787725314973554677945454022515297863304581,2,1,1,0.004601713741669311,0.02907579435939621,Brix <= 11.28,0
120,523896112575631378024934931557314815003807468929,2,1,1,0.0002115730455939913,0.0007858322799836814,Brix > 9.88,3
121,533735226380233132854068706426231558692711368887,3,1,2,0.0050777530942557915,0.18342635135285762,Brix > 9.28,1
122,549746515891163843617425559522791667429845420065,3,1,2,0.011953877076060508,0.2623669459356946,moisture <= 87.83,4
123,552082128732713621031558299075311834055380285421,2,0,2,0.0,2.1348200372422403,Tit Acid <= 0.27,0
124,5771222888430697625926571315532113256585960605,7,2,5,0.017454776261504282,0.4070947995578319,pH <= 4.85,1
125,568484349403032706442811090722432144818001088423,5,2,3,0.002062837194541415,0.03221912347933094,pH <= 4.32,4
126,636091658639320017876099791131110476351290392097,2,1,1,5.289326139849783e-05,0.0031433291199347256,moisture > 87.78,1
127,644675602832081649327117396129484128393056484155,2,1,1,0.0,0.015716645599673628,moisture <= 87.78,4
128,792760025352293005683938330994589112688689251669,3,1,2,0.0020099439331429172,0.018859974719608354,moisture > 87.83,1
129,589510874184243909852711938308467260254259432359,2,1,1,0.0,0.014144981039706263,moisture > 82.23,1
130,642112573656807165703313015619896940450767607790,5,1,4,0.004760393525864805,1.7472400726373354,Tit Acid <= 0.18,0
131,772317062733778050680538070298870766917603346383,2,1,1,0.0002115730455939913,0.0007858322799836814,Brix <= 9.88,0
132,665349927789854546665190254614539114508329105543,2,0,2,0.0,2.3657034838466786,pH > 4.25,0
133,999449005863449650043698603557860460414697697202,5,1,4,0.0010049719665714586,0.17229372738642215,Tit Acid > 0.18,1
134,665763256441369002694541083156400242042163903310,2,1,1,0.0002115730455939913,0.0031433291199347256,Tit Acid > 0.28,4
135,679457994161468121604690233924775229118954641934,5,2,3,0.004231460911879826,0.04976937773229982,pH > 4.32,1
136,832773610056439029892754125124439324367450502547,2,1,1,0.0006876123981804718,0.0015716645599673628,pH <= 3.96,4
137,940350166092675029613861939749538763040688165718,2,1,1,0.0,0.006286658239869451,moisture > 87.68,0
138,953013916229408958655391420495312068437993458202,2,0,2,0.0,0.18801037298609577,pH <= 4.75,1
