,Node,Degree,In degree nodes,Out degree nodes,Betweenness centrality,Local reaching centrality,Label,Community
0,101808344089847205341711026940422587424002819247,2,1,1,0.00022104332449160034,0.004703454399289682,pH > 5.41,0
1,1195054242563020476783971172209845772931465202363,10,10,0,0.0,0.0,Class 4,0
2,1040952865803721929906599721084890774852026858547,2,1,1,0.00011052166224580017,0.004703454399289682,Pheno > 0.72,1
3,928621589127927934620961952074257259595278295629,24,24,0,0.0,0.0,Class 2,1
4,1078664175220452826181491234246161857680321264899,2,1,1,0.00014736221632773356,0.0015678181330965606,Pheno <= 0.78,2
5,150913633418211931633209064051558675044205003315,18,18,0,0.0,0.0,Class 3,2
6,1079532077863388015675598726043094095716087110024,2,1,1,0.00014736221632773356,0.0007839090665482803,pH > 4.01,3
7,171982518954274878349485416184092168691833932185,9,9,0,0.0,0.0,Class 1,3
8,1082048259293728021355499586353010410433592618954,3,1,2,0.008989095195991748,0.09949112569608591,moisture > 87.02,1
9,1133159116889617656789667783688475393360249653467,2,1,1,0.00014736221632773356,0.003135636266193121,moisture <= 87.68,2
10,940350166092675029613861939749538763040688165718,3,1,2,0.007883878573533745,0.055265589191653766,moisture > 87.68,1
11,1084251021297852025110799230501022317851666576367,2,1,1,0.00014736221632773356,0.0007839090665482803,Tit Acid > 0.16,2
12,108695551173216811220809398532289050002057560322,8,3,5,0.0065207780725022105,0.0321402717284795,pH > 5.16,1
13,1329907479955885769404976189624453827909930603141,2,1,1,0.0,0.010190817865127644,moisture <= 89.16,1
14,624005623655726474188392415263575322370572793900,2,1,1,0.0003684055408193339,0.0007839090665482803,Pheno <= 0.72,0
15,880906355044111715629274031211066252453008613553,2,1,1,0.0003684055408193339,0.0015678181330965606,moisture > 89.16,2
16,1097393218549485926510675082709423471387496958586,3,1,2,0.002357795461243737,0.004703454399289682,pH > 5.34,0
17,1110568790232959905630420289486502087486430946508,2,1,1,0.0002947244326554671,0.0015678181330965606,moisture <= 88.83,0
18,158006808477048146119712560775676464229610946645,2,1,1,0.00014736221632773356,0.0007839090665482803,moisture > 88.83,2
19,1131648872527188645017649934457144056207019767356,3,1,2,0.001031535514294135,0.012542545064772485,Brix > 12.0,2
20,526047352448732854443680809168250965427631523486,2,1,1,0.00022104332449160034,0.002351727199644841,pH <= 4.98,1
21,825792580619614131751020977051041803762036359722,2,1,1,7.368110816386678e-05,0.003919545332741402,pH > 4.98,2
22,114288386783329094858692510758135355427541248708,8,3,5,0.009394341290893015,0.04272304412688128,pH <= 5.16,1
23,363527198380171677164642678006029696042250523634,2,1,1,0.0,0.004703454399289682,moisture <= 88.35,2
24,606472261887217459912504716286461793220012175689,3,1,2,0.0030946065428824046,0.01724599946406217,moisture > 85.13,1
25,759783886644566511118470111056334794848645516977,2,1,1,0.0003315649867374005,0.0015678181330965606,moisture > 88.35,1
26,867891166252050599975181215235547111412275904906,2,1,1,0.0,0.003135636266193121,moisture <= 85.13,2
27,117911845997659458962524310322336003992413561912,2,1,1,0.00014736221632773356,0.0007839090665482803,moisture > 87.77,1
28,1200230442900566009235442248446334046045517526,3,1,2,0.0005894488653109342,0.02038163573025529,moisture > 88.49,1
29,122445604033908938473078190630948358698133432926,2,1,1,7.368110816386678e-05,0.0007839090665482803,Brix <= 8.88,0
30,158059194345770793863619625413686121428844757978,2,1,1,7.368110816386678e-05,0.009406908798579364,Brix > 8.88,1
31,1202281202334859649737464243089883719203118393624,2,1,1,0.0,0.01646209039751389,moisture <= 88.03,4
32,1147257542945440298109815666246017244067397811172,8,8,0,0.0,0.0,Class 0,4
33,1220406208029421398891215352067484920853928295930,5,2,3,0.016578249336870025,0.8872525453714037,Pheno > 0.62,1
34,642112573656807165703313015619896940450767607790,6,2,4,0.0212938402593575,0.6067978781128055,Tit Acid <= 0.18,1
35,999449005863449650043698603557860460414697697202,3,2,1,0.0005894488653109342,0.0015678181330965606,Tit Acid > 0.18,2
36,1222606835484573781895929093124951088888598819094,2,1,1,7.368110816386678e-05,0.003135636266193121,pH <= 5.09,2
37,1233198855909382054836554163560023233305861086389,4,2,2,0.0005894488653109342,0.005487363465837962,Pheno <= 0.62,0
38,1237265994102648826715151826126075249469806378295,3,1,2,0.001326259946949602,0.004703454399289682,Brix <= 9.28,2
39,41417030911434338004125230269439804259879445302,2,1,1,0.00014736221632773356,0.0007839090665482803,Pheno > 0.78,1
40,1237929490392718556791145078841139784211144198794,6,2,4,0.01097848511641615,0.19225369857096578,Tit Acid <= 0.15,1
41,1459505541307075317069583903840023895269513889914,5,2,3,0.010610079575596816,0.06820008878970041,Pheno <= 0.7,1
42,505999025934227433070684395903690609806529295127,2,1,1,0.0003684055408193339,0.003135636266193121,pH > 5.09,0
43,945983268971432222548859207615769581540823239463,5,2,3,0.001694665487768936,0.10582772398401784,Pheno > 0.7,1
44,124210201951521362978433460778195822768531021450,3,1,2,0.0009578544061302681,0.006271272532386242,Pheno > 0.75,4
45,1412576102911718948876177982029926049863052796532,2,1,1,0.00022104332449160034,0.002351727199644841,pH <= 4.01,4
46,1308425805814366873910502507832070611603025885708,3,1,2,0.0011052166224580018,0.01881381759715873,pH <= 5.17,1
47,549746515891163843617425559522791667429845420065,2,1,1,7.368110816386678e-05,0.004703454399289682,moisture <= 87.83,2
48,792760025352293005683938330994589112688689251669,2,1,1,0.00014736221632773356,0.004703454399289682,moisture > 87.83,1
49,1317131137490315402024263102743181549566993569198,2,1,1,0.0,0.003135636266193121,Brix <= 10.68,3
50,1318822404969436576495506178898297352498154514535,2,1,1,0.00014736221632773356,0.002351727199644841,Brix > 13.02,1
51,1351945955060965088498220515028432149719863926292,3,2,1,7.368110816386678e-05,0.02822072639573809,Tit Acid <= 0.11,0
52,1357380160954851576082634284048494310505447364862,2,1,1,0.0012525788387857352,0.0015678181330965606,moisture > 87.7,2
53,586708634388312476388084826066397854628523484172,2,1,1,0.0002947244326554671,0.0007839090665482803,Brix <= 10.82,2
54,1372376111315669287850628471356060458106754933825,2,1,1,0.0002947244326554671,0.0007839090665482803,Brix <= 10.22,3
55,1375456881799729951521866427476070429249136782258,3,1,2,0.009725906277630415,0.16847512355233457,Pheno <= 0.83,1
56,596499728078599072988654454424180549206663945954,2,1,1,7.368110816386678e-05,0.01567818133096561,moisture <= 87.02,1
57,14031532405571743634624912828080204254597625767,3,1,2,0.0011052166224580018,0.014110363197869045,pH > 5.17,1
58,153190256752309298641849943950418323697184319165,2,1,1,0.00014736221632773356,0.0007839090665482803,moisture > 89.35,2
59,868946321800397981410011141217634304658769961352,2,1,1,7.368110816386678e-05,0.006271272532386242,moisture <= 89.35,1
60,1405395433493292145183461183700747787876089761855,3,1,2,0.0002947244326554671,0.03135636266193122,pH <= 4.25,4
61,673794176245197217307081310071062228669787260547,2,1,1,0.00014736221632773356,0.014894272264417327,Brix > 10.38,4
62,970244233178621150864039654935840188579193162108,2,1,1,0.00014736221632773356,0.0007839090665482803,Brix <= 10.38,3
63,1422967542425949721261238579709952580993794609712,3,1,2,0.0012525788387857352,0.03449199892812434,Brix > 10.68,4
64,469361508389853439729697629011115598507104148813,2,1,1,0.0,0.012542545064772485,Pheno <= 0.75,4
65,1436202689171701946909271625929195695076075885598,2,1,1,0.00025788387857353373,0.003135636266193121,pH > 5.03,1
66,1440335382918687438535224440716847939872691334081,3,1,2,0.0030946065428824046,0.14933467717744742,Pheno <= 0.76,1
67,1441655350341890941614520753917652373824477167080,2,1,1,0.0002947244326554671,0.0007839090665482803,Tit Acid <= 0.16,1
68,253922261890430999205267669682022302178631037563,3,1,2,0.009283819628647215,0.05160734688109512,pH > 5.12,1
69,734688343688369556113059663312243972070074525881,2,1,1,0.0,0.007055181598934522,pH <= 5.12,1
70,177267499210149510724253963525281511412675617616,2,0,2,0.0,1.5066732259057944,pH > 4.75,1
71,227433626263115702977273694017012744327541066228,8,2,6,0.014294134983790155,1.1347569015327554,Tit Acid > 0.11,1
72,180087590449994414434638415576357070068029946541,3,2,1,0.00022104332449160034,0.0015678181330965606,Brix > 13.12,1
73,227367995596712800920562994603144313835373533341,6,2,4,0.007294429708222811,0.03187896870629673,Tit Acid > 0.15,1
74,276905622826971952127785100475691107168588255039,2,1,1,0.00025788387857353373,0.003135636266193121,moisture <= 87.7,1
75,752858087326450445032258197887178540403040319630,3,1,2,0.00206307102858827,0.012542545064772485,pH <= 5.03,1
76,708974994663940473356047250801743764720458270635,3,1,2,0.002652519893899204,0.05395907408073997,Pheno > 0.76,1
77,846755632185994819502766419529589014377703441472,3,1,2,0.007073386383731211,0.35417011626651307,Brix <= 12.0,1
78,245684303784715268847019968464377942558661637315,3,1,2,0.0002947244326554671,0.04350695319342956,Pheno > 0.59,3
79,950777180855255984755872747437635027007930381761,3,2,1,0.00014736221632773356,0.03135636266193122,Brix <= 13.12,3
80,272977833151769436873634510482870044006295702260,2,1,1,0.0,0.013326454131320765,Brix <= 11.22,1
81,282661852526184494594935425846587408324666447561,2,1,1,7.368110816386678e-05,0.0015678181330965606,moisture <= 82.23,1
82,284206613161054309682069943008232583179454839881,3,1,2,0.00434718538166814,0.176183562706726,moisture <= 88.49,1
83,712979755472354743209619751389951397039451283185,2,1,1,0.00014736221632773356,0.002351727199644841,Brix > 12.5,1
84,834869891909695021872003804134137938819291017988,3,1,2,0.004715590922487474,0.10582772398401784,Brix <= 12.5,1
85,303427651036728708663818405774914844390855506685,3,1,2,0.0003684055408193339,1.0885305304584663,pH <= 5.41,1
86,316815797132631054908858426945402215223444395611,2,1,1,7.368110816386678e-05,0.0007839090665482803,pH > 5.58,1
87,317003839622419703814735346711666784282633035456,2,1,1,7.368110816386678e-05,0.014110363197869045,Brix > 10.22,4
88,337796743249264356585254730593921729601208626724,2,1,1,0.0,0.012542545064772485,Brix <= 13.02,3
89,376612186539264535272189631436137259606555864194,2,1,1,7.368110816386678e-05,0.012542545064772485,pH <= 5.58,0
90,384165568604620773602991426913274488186991046821,3,1,2,0.007294429708222811,0.9234554569447722,Tit Acid <= 0.28,1
91,589510874184243909852711938308467260254259432359,3,1,2,0.010462717359269083,0.886550760111827,moisture > 82.23,1
92,402551501852144362591499086205357905265844403402,3,1,2,0.00412614205717654,0.07029051296716247,Pheno > 0.74,1
93,533735226380233132854068706426231558692711368887,3,1,2,0.002357795461243737,0.03161766568411398,Brix > 9.28,1
94,431500440665982291877861151163819974354623898398,3,1,2,0.000663129973474801,0.07564722492190905,Tit Acid <= 0.26,3
95,435639610782896619166063496621213255249377764557,2,1,1,0.0002947244326554671,0.0007839090665482803,Pheno <= 0.59,4
96,47635510756424328729794967520824764353044331683,8,2,6,0.010610079575596816,2.209778065744373,pH > 4.85,1
97,494127393420143926044921388078061355092756508432,3,1,2,0.000663129973474801,0.029788544528834653,Tit Acid > 0.26,4
98,497763542274658046246028816444402973884179748326,2,1,1,7.368110816386678e-05,0.0015678181330965606,Pheno > 0.83,2
99,507738502140874341318067517546019802376185247900,2,1,1,0.00014736221632773356,0.0007839090665482803,moisture <= 87.77,2
100,520408378444148052535090774918801091096096873386,2,1,1,7.368110816386678e-05,0.004703454399289682,pH <= 5.0,1
101,532713744300870815677350821848934444001877176071,2,1,1,0.0,0.009406908798579364,Pheno > 0.69,1
102,922311927435954455015399968817795198456525739825,3,1,2,0.0014736221632773356,0.003135636266193121,Brix > 11.22,1
103,568484349403032706442811090722432144818001088423,5,1,4,0.0017683465959328027,0.0943303910079764,pH <= 4.32,4
104,585831330631376020196651220005217173751910922427,2,1,1,7.368110816386678e-05,0.002351727199644841,moisture > 88.03,3
105,5771222888430697625926571315532113256585960605,10,2,8,0.007957559681697613,2.5880157457290505,pH <= 4.85,4
106,665763256441369002694541083156400242042163903310,2,1,1,0.0,0.013326454131320765,Tit Acid > 0.28,4
107,679457994161468121604690233924775229118954641934,5,1,4,0.003610374300029472,2.8599793090668153,pH > 4.32,1
108,941244954744452374879064598878143830366660406032,2,1,1,7.368110816386678e-05,0.006271272532386242,moisture <= 87.54,1
109,94515194669438306255100726188346520486372319968,2,1,1,7.368110816386678e-05,0.002351727199644841,moisture > 87.54,2
110,622598769667804494137629575765384734315163051315,3,1,2,0.004273504273504273,0.02377857501863117,pH <= 5.34,1
111,692974179782182730962353172046240081223686466110,3,1,2,0.0025051576775714703,0.003135636266193121,Pheno <= 0.69,2
112,665349927789854546665190254614539114508329105543,2,1,1,0.0,0.01567818133096561,pH > 4.25,3
113,866219661844517520440105737257897458358104236613,2,1,1,7.368110816386678e-05,0.0015678181330965606,pH > 5.0,2
114,763212543587750217808106594112871041545025736785,2,0,2,0.0,2.8216281133610726,Tit Acid > 0.12,4
115,775650655566268222195963750769541160664287144256,2,0,2,0.0,0.02665290826264153,Tit Acid <= 0.12,0
116,850680869277507842791030455333102941280107573886,3,1,2,0.004862953138815207,0.21030973740379452,Pheno <= 0.74,1
117,953013916229408958655391420495312068437993458202,2,0,2,0.0,0.08570739127594532,pH <= 4.75,4
