,Node,Degree,In degree nodes,Out degree nodes,Betweenness centrality,Local reaching centrality,Label,Community
0,1010046219272533096104760473819206042211739377642,2,1,1,8.093758093758094e-06,0.0010155678348850706,pH > 4.16,0
1,1147257542945440298109815666246017244067397811172,37,37,0,0.0,0.0,Class 0,0
2,1012727215149894940790962895659570598163314844401,3,1,2,0.002161033411033411,0.005077839174425353,pH <= 4.52,1
3,108373009243295741366769533404488704288210765092,2,1,1,8.093758093758094e-06,0.0015233517523276059,pH > 4.24,1
4,988013392528626659652324335175339418871169925632,2,1,1,9.712509712509713e-05,0.0010155678348850706,pH <= 4.24,0
5,101808344089847205341711026940422587424002819247,2,1,1,4.856254856254856e-05,0.0005077839174425353,pH > 5.41,2
6,1195054242563020476783971172209845772931465202363,24,24,0,0.0,0.0,Class 4,2
7,1023651890920404556613481721436518695026650286074,2,1,1,8.093758093758095e-05,0.0015233517523276059,Tit Acid > 0.41,0
8,1036388000295638467941195363813167672284269136557,3,1,2,0.006798756798756799,1.0449911271066465,pH > 5.22,3
9,1098185664989343046012160366509114351270866542056,12,6,6,0.03884599197099198,1.2189895681940668,Tit Acid > 0.14,3
10,905638127712786336374745985074473946082791119647,11,5,6,0.06079626392126392,1.0643271655527065,Tit Acid <= 0.14,2
11,1036514887168965488969427841042546784303262242115,2,1,1,2.428127428127428e-05,0.0005077839174425353,Tit Acid > 0.2,1
12,171982518954274878349485416184092168691833932185,49,49,0,0.0,0.0,Class 1,1
13,1039644001710311114305057624204376969195728974014,5,2,3,0.006547850297850298,2.9143037814474027,Tit Acid <= 0.23,3
14,177267499210149510724253963525281511412675617616,3,1,2,0.006766381766381767,2.004480366357544,pH > 4.75,3
15,953013916229408958655391420495312068437993458202,2,1,1,0.0,0.004570055256982817,pH <= 4.75,1
16,1040952865803721929906599721084890774852026858547,4,2,2,0.00026304713804713804,0.0015233517523276059,Pheno > 0.72,3
17,928621589127927934620961952074257259595278295629,55,55,0,0.0,0.0,Class 2,3
18,1041607990320541634786254916604009322917316258345,3,1,2,0.00428969178969179,1.6425013434498892,pH > 4.8,3
19,14019385422964220106431955229528509600988724262,12,5,7,0.018596758180091513,1.4522150047048807,Tit Acid <= 0.13,3
20,947349482492510815730367502829189066919667400905,14,5,9,0.0891729797979798,1.4552936497286846,Tit Acid > 0.13,3
21,1049816460094094333888645061217613824805060281861,3,1,2,0.0020881895881895885,0.0030467035046552117,moisture > 87.33,0
22,1098687669563514264025770275896785710322424675602,2,1,1,8.093758093758094e-06,0.0005077839174425353,pH <= 4.16,1
23,1050039872014797098968605105705168881060474258636,4,2,2,2.428127428127428e-05,0.0035544874220977472,Pheno > 0.79,3
24,150913633418211931633209064051558675044205003315,37,37,0,0.0,0.0,Class 3,4
25,1053225159289587574630473585300564696766328452081,2,1,1,8.093758093758094e-06,0.0025389195872126766,pH <= 4.78,1
26,1057181954235649912767741917022286726850621989181,3,1,2,0.004144004144004144,0.004908577868611175,moisture > 87.59,3
27,556717024148382109869513597341354447788045885353,3,1,2,0.0021043771043771043,0.002031135669770141,Brix <= 9.67,3
28,745989050522176935633753143674321830157873901913,2,1,1,8.093758093758094e-06,0.0005077839174425353,Brix > 9.67,1
29,1061646991486779264187939494663666819323664224659,3,1,2,0.0017806267806267807,2.1537415254658456,Pheno > 0.65,3
30,1235093281777064867837067065838604278180603613708,9,3,6,0.04072779072779073,1.680824008191827,Tit Acid <= 0.22,3
31,1298003787753353473101990651810802389474599526622,8,3,5,0.03350006475006475,1.7803451694304975,Tit Acid > 0.22,0
32,1063376167394178517231959089415764487716126423999,3,1,2,0.004678192178192178,0.015165813000950386,moisture <= 86.39,3
33,271961166575545366369298194527985464851498533780,2,1,1,4.046879046879047e-05,0.0010155678348850706,moisture > 85.69,3
34,864661859434817211801535702929659248092878784662,3,1,2,0.002638565138565139,0.009774840410768804,moisture <= 85.69,3
35,1064722700211612430482514847059080720237476709767,2,1,1,1.214063714063714e-05,0.0015233517523276059,Tit Acid <= 0.25,0
36,1065559609151379155284735222300165508439141875420,2,1,1,0.0,0.0010155678348850706,Brix <= 12.19,4
37,1066695126837972460412703250391981521659112068837,2,0,2,0.0,2.565284414157037,Brix > 10.94,3
38,1220406208029421398891215352067484920853928295930,3,1,2,0.00021043771043771046,2.090535432344578,Pheno > 0.62,3
39,1233198855909382054836554163560023233305861086389,3,1,2,0.0023229085729085733,1.6456361566797475,Pheno <= 0.62,3
40,1068934606335878284657041109193465099796113944120,3,1,2,0.002314814814814815,3.7194430596037247,Tit Acid > 0.09,3
41,818300426017039898302815959957484483327736126221,5,2,3,0.004176379176379177,0.006855082885474226,Tit Acid > 0.23,0
42,1070714795032507544760283061226237462475556627885,2,1,1,1.618751618751619e-05,0.0005077839174425353,Brix > 9.25,3
43,1075406946632204589599345773866458656680532336106,2,1,1,3.237503237503238e-05,0.0005077839174425353,moisture <= 83.04,3
44,1077669966416905743304999731359916793456161937605,2,1,1,0.00015782828282828284,0.0010155678348850706,Brix > 11.55,2
45,1078664175220452826181491234246161857680321264899,12,5,7,0.02600524475524476,2.8646950456358797,Pheno <= 0.78,3
46,335318240806721174271477968450102581936058348348,2,1,1,0.001185735560735561,0.004062271339540282,moisture <= 87.59,3
47,556745548993839303618359875554171650973913630373,3,1,2,0.016843110593110593,1.486734885609167,Pheno <= 0.65,2
48,1081449991658252856513521415978250806683185838239,2,1,1,0.0,0.006601190926752959,pH <= 4.2,0
49,1084251021297852025110799230501022317851666576367,10,5,5,0.004510921177587845,0.010155678348850707,Tit Acid > 0.16,3
50,1199836470360426511221802180799545605954411878979,2,1,1,0.00017806267806267807,0.0005077839174425353,pH <= 5.11,1
51,374326721284177629101053874920649424179999036404,2,1,1,6.205214538547873e-05,0.0005077839174425353,pH > 5.11,4
52,520408378444148052535090774918801091096096873386,2,1,1,0.0,0.0010155678348850706,pH <= 5.0,1
53,866219661844517520440105737257897458358104236613,2,1,1,6.205214538547873e-05,0.0005077839174425353,pH > 5.0,4
54,1086643580389186385648825621674121023303688601056,2,1,1,7.284382284382284e-05,0.0010155678348850706,Tit Acid > 0.33,0
55,108695551173216811220809398532289050002057560322,2,0,2,0.0,1.4316822471173016,pH > 5.16,3
56,1095883835307482183503243507799832602731810164034,2,1,1,8.093758093758094e-06,0.0010155678348850706,pH > 4.27,1
57,1097902819252124410424749277226738477057041139957,3,1,2,0.004152097902097902,0.012525336630249205,moisture <= 86.82,1
58,1380182139590358552417025152630431100084044367147,3,1,2,0.0021205646205646207,0.010494200960479061,Brix <= 11.7,1
59,340541323206606717962189848457707874412358636521,2,1,1,0.0,0.0015233517523276059,Brix > 11.7,1
60,1151684139108188992227777924983826154453017451998,7,3,4,0.050675019425019445,1.0976703055605108,Pheno > 0.67,4
61,341697432501618660556921926132231886294070036119,6,3,3,0.007640507640507641,0.013210844918796627,Pheno <= 0.67,1
62,624005623655726474188392415263575322370572793900,4,2,2,0.009635619010619009,1.4225407979566436,Pheno <= 0.72,3
63,1105409889957482382147904612606127892453833009698,5,2,3,0.0033912846412846413,0.005585623091867888,Tit Acid > 0.24,0
64,1172701435691027738753025288653525731227105037060,2,1,1,1.214063714063714e-05,0.0015233517523276059,moisture <= 88.8,0
65,16769566651221792157231450049135750503234403831,2,1,1,3.237503237503238e-05,0.0005077839174425353,Tit Acid > 0.25,1
66,1109473617230747653753686183885584306394833404050,3,1,2,0.0021043771043771043,1.8508852427681917,Brix <= 11.14,3
67,234441933627735289965281891172678086869419897446,3,1,2,0.0022055490805490807,2.0313677882881573,Brix <= 11.0,3
68,72327627844386361034506630257391595902933838976,3,1,2,0.0021893615643615643,2.031706310899786,Brix > 11.0,3
69,1110286006501510599660955608137587775701142963526,3,1,2,0.0038202538202538206,0.987164583910107,pH <= 5.14,1
70,1187360199162734959084413965255746161794385449469,3,1,2,0.006118881118881119,0.9442582900642797,Brix > 9.8,1
71,1191406040714575450342483790479019848796166491923,2,1,1,2.428127428127428e-05,0.0015233517523276059,Brix <= 9.8,1
72,1110568790232959905630420289486502087486430946508,3,1,2,0.003108003108003108,0.012017552712806667,moisture <= 88.83,3
73,638254941434425009241185403461603115291452345245,3,1,2,0.0010764698264698266,0.0030467035046552117,Brix > 10.76,4
74,906280855876593157635545003122736618448311494803,2,1,1,0.0,0.004062271339540282,Brix <= 10.76,3
75,1115553694368208956972528467008670413289210180059,5,2,3,0.014843952343952345,2.045294762686284,pH > 4.09,1
76,124210201951521362978433460778195822768531021450,8,4,4,0.08368136493136495,2.309024814988123,Pheno > 0.75,3
77,469361508389853439729697629011115598507104148813,14,5,9,0.05667249417249417,2.0945590167947485,Pheno <= 0.75,1
78,1120903904305686376807339180315138316946784276765,3,1,2,0.000598938098938099,0.006008776356403334,Brix <= 14.55,3
79,1164855885306831319184235241463983184084645723167,3,2,1,2.0234395234395237e-05,0.002031135669770141,pH <= 4.54,1
80,116714911697737382047441536574520846070686499340,5,2,3,0.0032091750841750843,0.0030467035046552117,pH > 4.54,3
81,1121632004201231542391068396138858316221906157889,3,1,2,0.0021205646205646207,0.002031135669770141,pH > 4.91,2
82,122445604033908938473078190630948358698133432926,2,1,1,3.237503237503238e-05,0.0005077839174425353,Brix <= 8.88,2
83,158059194345770793863619625413686121428844757978,2,1,1,1.618751618751619e-05,0.0005077839174425353,Brix > 8.88,3
84,1121855515770154852410290409449112403849897227292,2,1,1,3.237503237503238e-05,0.0005077839174425353,moisture <= 78.02,4
85,1123813039185387328847940573523349697655945745154,2,1,1,2.428127428127428e-05,0.0005077839174425353,moisture <= 77.57,4
86,1136240926082328168886313995259017748045748129998,2,1,1,3.237503237503238e-05,0.0010155678348850706,Pheno <= 0.64,1
87,1138227443913740506058274027235633170219865754505,5,2,3,0.045729733229733234,1.98174637454362,Tit Acid <= 0.21,3
88,1240466776276824222017031893427282886635574916775,3,1,2,0.01630892255892256,2.067427281257313,pH > 4.99,3
89,1447020924709357829249665852444662160906055523561,3,1,2,0.029663623413623417,1.3817488361031205,pH <= 4.99,3
90,114189968201256226507441273296838158293259521330,2,1,1,4.856254856254856e-05,0.0005077839174425353,Brix <= 11.32,4
91,114288386783329094858692510758135355427541248708,4,1,3,0.044734200984200986,4.3601992028071646,pH <= 5.16,3
92,531509356863486706025982339411863302481303645584,5,2,3,0.04642174954674955,0.9601107841823442,Brix <= 9.91,3
93,892641096355272269845543261565401309761422639964,5,2,3,0.00411972286972287,3.8182065566789958,Brix > 9.91,3
94,114417977878880735374340839360950363312987496982,2,0,2,0.0,4.438225196988017,pH > 4.41,3
95,149702574861862781640897559315302020438679772497,2,1,1,8.093758093758094e-06,0.0025389195872126766,Tit Acid <= 0.09,2
96,1237929490392718556791145078841139784211144198794,15,5,10,0.05805652680652681,0.9843690932865109,Tit Acid <= 0.15,4
97,227367995596712800920562994603144313835373533341,6,3,3,0.03352434602434603,1.7002710556761154,Tit Acid > 0.15,1
98,1153417406874620875477637336154330185777695478090,2,1,1,0.033710502460502466,1.7747965944426285,moisture > 83.75,1
99,1308425805814366873910502507832070611603025885708,3,1,2,0.03499740999741,1.8539267213234458,pH <= 5.17,1
100,1295960832990774694751889211742613816364524779343,2,1,1,0.0010967042217042218,0.0010155678348850706,Brix <= 12.83,1
101,1378614789273833145083975234257509177572274484264,2,1,1,8.093758093758094e-06,0.0005077839174425353,Brix > 12.83,3
102,1170214555683808590798108500479380442752191698990,2,1,1,8.093758093758094e-06,0.0005077839174425353,pH <= 3.64,0
103,1179307966795094331079735577613054875122803952110,3,1,2,0.008733164983164983,1.3341657679026495,moisture > 82.41,3
104,459710425420134478586444207626522368596952442246,2,1,1,0.008992165242165243,0.9355861212741594,Brix > 11.66,4
105,924260886117282214700599762932344738097292877517,3,1,2,0.0,1.1080293213991885,Brix <= 11.66,3
106,1179748637485698376043865247738973137077653953684,3,1,2,0.003261784511784512,0.025685403157301577,moisture <= 87.79,1
107,431500440665982291877861151163819974354623898398,5,2,3,0.0033103470603470606,0.014133319035483899,Tit Acid <= 0.26,1
108,494127393420143926044921388078061355092756508432,3,2,1,4.856254856254856e-05,0.0010155678348850706,Tit Acid > 0.26,0
109,1181504877852149003572992857613830846974179669922,2,1,1,8.093758093758094e-06,0.0005077839174425353,moisture > 90.86,2
110,1183095263998325490897206552893338214712556693392,3,1,2,0.011092495467495469,1.0819488405428794,moisture > 78.02,3
111,119301423525731187517967532278343815174362677337,3,1,2,0.011302933177933178,1.1416092512217437,moisture > 84.3,3
112,277838038800051883697216638760365392108712858277,2,1,1,4.046879046879047e-05,0.0010155678348850706,moisture <= 84.3,3
113,190373535843181436202405661235606844945328054365,3,1,2,0.00018615643615643617,0.009394002472686902,moisture > 84.91,1
114,390689622405582358421658391175588029757496401462,3,1,2,0.008223258223258223,1.0030948792926195,moisture <= 84.91,3
115,1190853731658875778202568083794893815496314613179,2,1,1,2.428127428127428e-05,0.0015233517523276059,Brix <= 10.28,1
116,1192868523207543668395459480650423217230777079348,3,1,2,0.021015442890442892,1.0556939162431824,Pheno <= 0.82,3
117,516601140442069092777768951925603503757731753522,3,1,2,0.018838221963221966,1.1245347210863632,pH <= 5.21,3
118,7502286575422847517785813269994352158580699271,3,1,2,0.002436221186221186,0.814882237847674,pH > 5.21,3
119,478988701995746220836729620311416045687869066757,8,3,5,0.0603956228956229,1.2368272298077487,Pheno <= 0.8,3
120,937787711282178832864130665432839185535877783171,5,3,2,0.00010521885521885523,0.0015233517523276059,Pheno > 0.8,4
121,1193196437593980692700981826145293546974506066116,2,1,1,8.093758093758094e-06,0.0005077839174425353,Brix > 11.95,0
122,1194551982078116586257583268357029260884961365376,3,1,2,0.004726754726754727,1.3635241673379879,moisture <= 88.22,0
123,1279844039703918997884095703828528221818683790498,3,1,2,0.0070496632996633005,1.454291452860591,Brix <= 11.06,1
124,248438178818573091628497364426317176239089470187,2,1,1,0.0,0.0035544874220977472,Brix > 11.06,0
125,1201960535396958139467932502500117568201874538629,2,1,1,1.214063714063714e-05,0.0005077839174425353,moisture <= 81.93,0
126,1204858209925897222925216697928866248786228823046,2,1,1,8.093758093758094e-06,0.0015233517523276059,Brix <= 9.49,2
127,1217884912855473183701012549888874898408190828252,3,1,2,0.017579642579642576,1.0038434486157966,moisture <= 87.09,4
128,175545555491426056943858551402811694992155579583,3,1,2,0.0025980963480963484,1.629171026427574,pH > 4.38,3
129,590081565621587515431066707911531937749332074909,3,1,2,0.00011331261331261332,0.026404763707011836,pH <= 4.38,0
130,1229270261957475338282130882941763708382891556644,2,1,1,2.428127428127428e-05,0.0015233517523276059,Brix > 12.41,1
131,1229347079255250543408299586035634797376275693713,2,1,1,2.428127428127428e-05,0.0010155678348850706,moisture <= 87.33,0
132,22299444265181951376006874183015402110349795518,4,2,2,2.428127428127428e-05,1.8614796956839101,pH > 4.95,3
133,637235121675842374134504446661437525158405032722,5,2,3,0.010906339031339031,1.0611053596009177,pH <= 4.95,3
134,1234609601028474526307517299734078385458241720167,2,1,1,2.428127428127428e-05,0.0005077839174425353,moisture <= 87.47,4
135,1297638582765570971178304788286998986277071689200,2,1,1,0.002225783475783476,1.1908798885612712,moisture > 73.04,3
136,130910188948100984394040813486364150271025483147,3,1,2,0.0021205646205646207,0.002031135669770141,moisture > 90.15,2
137,30573465449542453962392756566305676467799910962,2,1,1,2.428127428127428e-05,0.0005077839174425353,moisture <= 73.04,4
138,642112573656807165703313015619896940450767607790,8,3,5,0.013221153846153855,1.6091638440765126,Tit Acid <= 0.18,3
139,965426097790400467695380693242664745427138996783,3,1,2,0.005867974617974618,1.269913411651357,moisture <= 90.15,3
140,999449005863449650043698603557860460414697697202,3,1,2,0.02764827764827765,1.8828946031225378,Tit Acid > 0.18,1
141,1235811037754722330169136314640271062392362040553,2,1,1,1.618751618751619e-05,0.0005077839174425353,moisture > 84.44,0
142,1237770383266825801746566633527271572152532879110,2,1,1,0.00036421911421911425,0.0005077839174425353,moisture <= 81.78,0
143,1247566892266719794547618626797282432638165600122,2,1,1,3.237503237503238e-05,0.0005077839174425353,pH <= 5.06,3
144,1279277118470248049491918220694835009436228081531,2,1,1,0.0,0.0030467035046552117,moisture <= 87.41,4
145,241821156710561854083889010000595558158541903007,3,1,2,0.04452376327376328,0.9783107208489206,moisture > 87.41,3
146,420882672450711953685778385299921576823656385950,2,1,1,8.093758093758095e-05,0.0005077839174425353,pH <= 5.08,4
147,506604351442154279907754485682302558197425074816,2,1,1,0.001036001036001036,0.0010155678348850706,Brix > 12.19,4
148,53202860733200024026023219245065271666901395804,2,1,1,0.0,0.0010155678348850706,pH <= 5.04,4
149,790232291106810786815988388775216340577894965987,2,1,1,0.0,0.0010155678348850706,pH > 5.06,4
150,824241047817046928909952306547648190264910408440,3,1,2,0.004346348096348097,0.004062271339540282,pH > 5.08,4
151,954228811239594033357502191266040141914096422930,2,1,1,0.0,0.0010155678348850706,pH > 5.04,3
152,763212543587750217808106594112871041545025736785,3,1,2,0.008255633255633256,1.857421297513641,Tit Acid > 0.12,3
153,775650655566268222195963750769541160664287144256,3,1,2,0.008304195804195804,0.03826151817929503,Tit Acid <= 0.12,2
154,41417030911434338004125230269439804259879445302,11,4,7,0.06257284382284382,1.73626297439942,Pheno > 0.78,3
155,1245546997581260022666443016827456462869670114213,2,1,1,1.618751618751619e-05,0.0005077839174425353,pH > 5.59,3
156,1268834994066267126714212531962537133291228424484,5,2,3,0.03030707718207719,2.4571295749932385,Pheno > 0.73,3
157,1276810453078600040270949478387573991456066005105,2,1,1,8.093758093758094e-06,0.0010155678348850706,Pheno <= 0.66,3
158,1277909709325778818096916785111124886777034086674,3,1,2,0.007025382025382026,1.7638582868741453,Brix > 10.28,1
159,176645373172273420828484620192855170075859691379,6,2,4,0.0038121600621600625,1.0341092117913981,pH <= 4.09,1
160,1286209433107264406126985252848197299495082577717,3,1,2,0.005228567728567729,0.0071512901706490386,moisture > 81.78,1
161,26262123209431038897219755297914681850831133132,3,1,2,0.003172753172753173,0.004062271339540282,Tit Acid <= 0.39,1
162,365732877566896957786168909862900480790881506400,2,1,1,8.093758093758094e-06,0.0005077839174425353,Tit Acid > 0.39,0
163,1294715536720538980835333471735000550737165570301,2,1,1,0.001456876456876457,1.0654120372644316,Tit Acid > 0.17,1
164,712979755472354743209619751389951397039451283185,2,1,1,3.642191142191142e-05,0.0005077839174425353,Brix > 12.5,1
165,129704127352994401699893847168374652078269544461,3,1,2,0.006280756280756281,0.023104168243635356,Pheno > 0.56,2
166,709522578723862305770069290517222256340509360109,3,1,2,0.004233035483035484,0.011086615530828686,Brix > 9.49,2
167,1375399875471741495431433422769494526722335326932,3,1,2,0.007616226366226366,1.7848960256757274,moisture > 86.48,0
168,658708370755683951460474484090534411729195159179,3,1,2,0.011460761460761462,0.04362710157360449,Tit Acid <= 0.41,1
169,964730454324481872235560795563542447156877787575,3,1,2,0.012432012432012432,0.027361090084861938,moisture <= 86.48,0
170,1300965428224098083584542786860272113371821123277,3,1,2,0.003990222740222741,1.417442353486891,Brix <= 11.74,3
171,816382306734624810576405438803019166342408188903,3,1,2,0.004208754208754209,1.3497798336670768,Brix > 11.14,3
172,1306138064337432474499170095541317153206206943103,2,1,1,3.237503237503238e-05,0.0005077839174425353,Pheno <= 0.55,0
173,1424762211720957756902873119791486838317798019688,2,1,1,1.618751618751619e-05,0.0005077839174425353,moisture <= 91.13,1
174,1450496375163395839721635662846378703407596478081,2,1,1,4.856254856254856e-05,0.0005077839174425353,moisture > 91.13,2
175,1316070098940975335983536277503008973870132410966,2,1,1,0.01741776741776742,0.9394835855527753,Pheno <= 0.85,4
176,1321661511126510148468737894218929275593525496686,3,2,1,8.093758093758094e-06,0.005585623091867888,Tit Acid <= 0.1,2
177,1323794905782010694128521093358605841916050899389,3,1,2,0.0020881895881895885,0.0030467035046552117,pH <= 5.22,3
178,810250382472620947579229958469026811510227057892,2,1,1,8.093758093758094e-06,0.0010155678348850706,moisture > 87.47,3
179,1348222192386930823085293057342117903509521856801,2,1,1,0.0016025641025641027,0.013794796423855542,Brix > 10.12,3
180,1351945955060965088498220515028432149719863926292,5,2,3,0.004208754208754209,0.00871695724943019,Tit Acid <= 0.11,2
181,1455795230845802777918013132903327314833495343484,3,1,2,0.0021124708624708625,0.0030467035046552117,moisture <= 87.95,2
182,407056331533418999769103757709019114533594828372,2,1,1,5.665630665630666e-05,0.0005077839174425353,moisture > 87.95,2
183,1353822741269520035130178384551776432885805993826,3,1,2,0.002072002072002072,0.012186814018620847,Brix > 10.86,3
184,269691972290611216355971523650200205864002053328,2,1,1,8.093758093758094e-06,0.0035544874220977472,pH > 4.78,3
185,1359621009229284716935205666829144925176447621033,3,1,2,0.01346801346801347,1.1643550369732627,pH <= 5.26,3
186,1441655350341890941614520753917652373824477167080,11,4,7,0.13705295476128815,1.1974374593333226,Tit Acid <= 0.16,3
187,1360559255423146372610111696158536068419027788613,3,1,2,0.002076048951048951,0.008124542679080565,Tit Acid > 0.31,0
188,1366081949616292208744512455843331458351167972218,2,1,1,1.214063714063714e-05,0.0005077839174425353,Brix <= 10.02,1
189,915776135173734635733624239408657390277171150826,2,1,1,8.093758093758094e-06,0.0035544874220977472,Brix > 10.02,0
190,1360987528353510078407126011059862124220640303007,2,1,1,1.618751618751619e-05,0.0005077839174425353,moisture > 88.22,1
191,1369453848931345029933103539410755240102540067288,3,1,2,0.000938875938875939,2.5715574999616226,Tit Acid <= 0.17,3
192,654230765831910832364613877599787643313442292830,3,1,2,0.003233456358456359,3.215044605006568,pH > 5.45,3
193,871743260620983391299633283929437246488336693221,3,1,2,1.214063714063714e-05,2.407248327352076,pH <= 5.45,3
194,1371805337674407898275711717712071806982918337857,2,1,1,3.237503237503238e-05,0.0005077839174425353,Brix > 12.74,1
195,1373347432538866619505116869199797637013813938826,3,1,2,0.0023876586376586377,1.4181226945992116,pH <= 4.19,0
196,434980552850454240155732100423678165018043794092,3,1,2,0.005791083916083917,1.8982120397023217,Tit Acid <= 0.31,1
197,1379058987082517188855604202157317621401514448201,3,1,2,0.004249222999223,0.004231532645354461,moisture <= 85.5,0
198,306230200128400215091437277381736612343064418837,3,1,2,0.002144845894845895,0.002031135669770141,moisture <= 84.44,0
199,1383045789014029471710781731961807727090016907641,3,1,2,1.618751618751619e-05,3.6623547998654002,pH > 4.19,3
200,425950537542314473811980022578319522088182865590,3,1,2,0.002314814814814815,2.7715068191212975,moisture > 71.9,3
201,836004564429252488813951020922595834652797430924,2,1,1,8.093758093758094e-06,0.0005077839174425353,moisture <= 71.9,4
202,1385144062140078162558193597519163875851254985677,2,1,1,8.093758093758094e-06,0.002031135669770141,pH <= 3.75,0
203,1386691901693956780169467586885890447209598951478,2,1,1,2.428127428127428e-05,0.0005077839174425353,Tit Acid <= 0.19,1
204,1389845597516703181812529879143029582723265017342,2,1,1,1.618751618751619e-05,0.002031135669770141,pH <= 4.6,1
205,1390565464165431138895261137125313236449929179655,2,1,1,0.00018615643615643617,0.0005077839174425353,Brix > 10.54,1
206,1391436089974438774109670874224736679839775700271,5,2,3,0.0036583786583786588,0.020819140615143946,Pheno <= 0.73,2
207,594622317628574524279625113699187382625387045854,2,1,1,4.046879046879047e-05,0.0005077839174425353,Brix <= 10.12,4
208,1392316096367518349866276269041745411265815645303,2,1,1,1.618751618751619e-05,0.0010155678348850706,moisture <= 82.41,3
209,542587181052035438973110002434304419085007660766,6,2,4,0.016725751100751102,1.2895609193639708,Tit Acid > 0.1,3
210,567905170835719895825752398031504061926099469998,2,1,1,5.665630665630666e-05,0.0005077839174425353,Brix > 11.13,3
211,73528199168407328596459160988808329839271151930,3,1,2,0.0,1.455710250669943,Brix <= 11.55,3
212,80977916570598044051307388330326018563402609497,2,1,1,7.823966157299492e-05,0.0005077839174425353,Brix <= 11.13,4
213,1405245601027660786125741477698000295615911050563,3,1,2,0.0020962833462833466,0.005077839174425353,Pheno > 0.66,4
214,539841963763980928303120942267934660259153369307,2,1,1,8.093758093758094e-06,0.0005077839174425353,pH > 5.1,3
215,894406717605448330614352030725481623211153227930,2,1,1,1.618751618751619e-05,0.002031135669770141,pH <= 5.1,4
216,1406934934120251625612133221223658485807342486992,3,1,2,0.0026871276871276873,0.8394710776212779,Brix <= 9.39,3
217,1440335382918687438535224440716847939872691334081,3,2,1,0.0,0.002031135669770141,Pheno <= 0.76,3
218,708974994663940473356047250801743764720458270635,6,3,3,0.01723970473970474,0.9002426338488161,Pheno > 0.76,4
219,1410734861225614826957669090340285827285767854465,2,1,1,1.618751618751619e-05,0.0005077839174425353,pH <= 5.33,2
220,1420855393752826397476723276676391429574104930872,3,1,2,0.004144004144004144,0.010578831613386151,Pheno <= 0.81,4
221,1430171494093856240910218570031376795030403015577,2,1,1,8.093758093758094e-06,0.0005077839174425353,Brix > 11.25,3
222,1439157627400264411376365335601922955910930314266,2,1,1,2.428127428127428e-05,0.002031135669770141,Tit Acid > 0.29,0
223,1458924405464063515228681003248175979732942947901,3,1,2,0.004961473711473712,0.7888050134765062,Pheno <= 0.84,3
224,765592453115146640633038007468437610469124266623,2,1,1,0.0,0.0005077839174425353,Pheno > 0.84,3
225,946469583164485345996914984787775396258236729112,3,1,2,0.04081682206682208,0.9821961408387967,Pheno > 0.81,2
226,1446956719002272568855558192053020875241121414110,3,1,2,0.010222416472416474,0.03797377395941093,Tit Acid <= 0.33,1
227,594305372998091615540369694577692187104963013296,2,1,1,8.093758093758094e-06,0.0010155678348850706,pH <= 4.22,0
228,937403765014084242515053459650118407781227299456,3,1,2,0.008263727013727015,0.023451153920554423,pH > 4.22,1
229,586207411123808759976655522970393173686357326840,3,1,2,0.02523633773633774,1.3198842916765288,moisture > 86.39,3
230,144753638059622628806861579012763468719693272140,3,1,2,0.013589419839419841,1.22368487569007,pH > 4.89,2
231,227433626263115702977273694017012744327541066228,6,2,4,0.02373899248899249,1.279822259050505,Tit Acid > 0.11,3
232,1450476829875396438424828153392846571565048083844,2,1,1,8.093758093758094e-06,0.002031135669770141,pH > 4.21,1
233,1452446365081073637376382947680247931996315856640,2,0,2,0.0,2.440512898662831,pH <= 4.41,1
234,729975338000531002608581950108499682523859359044,3,1,2,0.00237956487956488,2.1974826304189623,pH > 3.64,1
235,829704520395958485353761463372577207502431999063,2,1,1,8.093758093758094e-06,0.0010155678348850706,Brix > 9.89,2
236,846018207069443445824676653278782823962292569938,2,1,1,3.237503237503238e-05,0.0005077839174425353,Brix <= 9.89,3
237,1458076921483226212222179841257653452184508102471,3,1,2,0.006361693861693862,0.021919339102936104,Tit Acid <= 0.32,1
238,756297897021004223295909235636130446250906912491,3,1,2,0.0021124708624708625,0.005077839174425353,moisture <= 87.16,1
239,933756729222335092793216951610122983063076054863,3,1,2,0.002233877233877234,0.010409570307571973,moisture > 87.16,0
240,231181347083149241591051667437200970404733148699,3,1,2,0.005212380212380212,0.8127738263317376,Brix > 10.88,3
241,678579799782929757328525100603297462527014574466,2,1,1,0.0,0.0015233517523276059,Brix <= 10.88,3
242,1459505541307075317069583903840023895269513889914,7,3,4,0.017741517741517738,0.95081975957229,Pheno <= 0.7,4
243,281426929804447327036007344464597780150040855481,2,1,1,3.237503237503238e-05,0.0005077839174425353,moisture > 87.09,4
244,147220081334260120105087561777675422179271749170,2,1,1,8.093758093758094e-06,0.0005077839174425353,Brix > 14.55,3
245,147860641729304468009300889158500163508655895047,2,1,1,1.214063714063714e-05,0.0010155678348850706,Tit Acid > 0.27,0
246,158006808477048146119712560775676464229610946645,2,1,1,0.0021327052577052577,2.4633756314074806,moisture > 88.83,3
247,314614043712472267125975167775062166135256544588,3,1,2,0.001027907277907278,1.3723481240265307,Brix > 11.74,4
248,185103442522261858230366081949197606782253884162,2,1,1,2.428127428127428e-05,0.0010155678348850706,moisture <= 87.63,0
249,958163794447047216498529922731709520086222296765,2,1,1,1.618751618751619e-05,0.0005077839174425353,moisture > 87.63,1
250,184042335899791461426488807510371112447431944346,2,1,1,0.0022905335405335406,1.2355810610574625,moisture > 83.04,2
251,428337588300963676283958377694182998226752112550,6,2,4,0.021675084175084177,1.2974776928037934,Tit Acid <= 0.29,2
252,189078214289674865644358532974550465226588841649,3,1,2,0.004407051282051282,2.3063674857601324,Tit Acid <= 0.2,3
253,527795530990880509741751660020745654720659278304,2,1,1,0.0,0.002031135669770141,Brix <= 10.4,1
254,70097823383559155292237270959669303832201318693,2,1,1,0.00016996891996891997,0.004654685909889906,Brix > 10.4,3
255,222419773618386845891899880742668937047644568917,3,1,2,0.0020962833462833466,0.004062271339540282,moisture > 86.29,2
256,578945386731621121066454334364960673642618887059,2,1,1,1.618751618751619e-05,0.0010155678348850706,moisture > 88.42,4
257,842184217077156338155513443582429322008237542243,2,1,1,8.093758093758094e-06,0.0010155678348850706,moisture <= 88.42,2
258,223301908176508386263497230968104390606799181686,2,1,1,8.093758093758094e-06,0.0005077839174425353,Brix <= 12.53,0
259,550900080730997224834446510634211792471714437226,2,1,1,6.475006475006475e-05,0.0005077839174425353,moisture <= 83.75,3
260,228019555939926981970315585528929600110199697385,3,1,2,0.025479150479150482,1.276637901802064,moisture > 87.03,3
261,229972872122238022294053787842320819454257767747,3,1,2,0.0020962833462833466,0.0030467035046552117,Pheno > 0.55,0
262,384165568604620773602991426913274488186991046821,2,1,1,8.093758093758094e-06,0.0010155678348850706,Tit Acid <= 0.28,0
263,665763256441369002694541083156400242042163903310,2,1,1,1.618751618751619e-05,0.0005077839174425353,Tit Acid > 0.28,1
264,859064382110568225416817075337968898422716111399,5,2,3,0.008340617715617716,0.8672035067495212,Pheno <= 0.79,4
265,233514774849967560490339294820318542895453405013,3,1,2,0.020772630147630148,1.109946648932932,Brix <= 10.96,3
266,730234002799503929354326135447071420040396685365,2,1,1,8.093758093758094e-06,0.0010155678348850706,Pheno > 0.82,3
267,529052830235461479044787831355661166693965463200,2,1,1,4.046879046879047e-05,0.0005077839174425353,moisture <= 86.92,4
268,703668007945996384365861252154344570501987254,3,1,2,0.004407051282051282,2.3063674857601324,moisture > 86.92,3
269,402551501852144362591499086205357905265844403402,8,3,5,0.024783087283087285,1.1127985110331486,Pheno > 0.74,3
270,850680869277507842791030455333102941280107573886,7,3,4,0.027247636622636625,1.040300962749252,Pheno <= 0.74,4
271,245684303784715268847019968464377942558661637315,3,1,2,0.004313973063973064,3.1064865429138098,Pheno > 0.59,3
272,447664605078082614813690311881368433506160665928,2,1,1,1.618751618751619e-05,0.0005077839174425353,moisture <= 75.78,4
273,53037336007018060845255065814220928603774890448,3,1,2,0.004548692048692049,2.142032929591119,moisture > 75.78,3
274,249030341527809223937443731273754878739806237380,3,1,2,0.004160191660191661,0.004908577868611175,moisture > 89.89,2
275,92385814583727389261064792543667060556475889632,2,1,1,8.093758093758094e-06,0.0005077839174425353,pH <= 4.91,1
276,253922261890430999205267669682022302178631037563,4,2,2,0.0001982970732970733,0.002031135669770141,pH > 5.12,3
277,792138996825164763961216789503536691928458420803,2,1,1,0.0010845635845635846,0.002031135669770141,Brix <= 11.95,1
278,269231723888614229279723687375537811294992806521,5,2,3,0.00819493006993007,1.1038190892751147,pH <= 5.01,3
279,620172969906758026226147666334760385832884834260,3,1,2,0.006317178192178192,1.1226656518487195,Brix <= 10.86,3
280,269985999564410014550431691212670634837935007440,3,1,2,0.012286324786324788,1.42575605191671,Brix <= 12.3,3
281,300983639737910739802524555895054313638023200021,2,1,1,1.618751618751619e-05,0.002031135669770141,Brix <= 9.99,3
282,747218799105151263391358894316127464133990799415,3,1,2,0.012521043771043771,1.3642147353794742,Brix > 9.99,3
283,27179484041025161924231712556228612435607858596,3,1,2,0.004726754726754727,1.9797393995772714,pH > 3.75,1
284,27422612100181239534411966719283935950524810046,3,1,2,0.012043512043512044,1.5332230953224433,pH > 4.52,3
285,732610074641892084255741575753171295594674388450,2,1,1,8.093758093758094e-06,0.0005077839174425353,Brix > 12.3,4
286,279844694759439463736615635979304852026338846030,2,1,1,0.0,0.0010155678348850706,Brix > 13.05,3
287,290708621864237198637923132626927314502717658789,3,1,2,0.006321225071225072,0.00871695724943019,moisture > 81.93,0
288,406952273850868512233800771899513292114191770765,2,1,1,1.618751618751619e-05,0.0010155678348850706,moisture > 85.5,1
289,295169623190637535697252647558642683553516168235,2,1,1,1.618751618751619e-05,0.0005077839174425353,moisture <= 85.46,0
290,303427651036728708663818405774914844390855506685,3,1,2,0.05355235042735043,1.5974184030084417,pH <= 5.41,2
291,314481329406331221346824442324578186096521671941,3,1,2,0.006216006216006216,0.011001984877921598,pH > 5.29,2
292,879777753611004235437037181589738421603931041991,2,1,1,0.047587250712250714,1.8315522254363457,pH <= 5.29,1
293,305375912038333805752515593852256379678918604245,2,1,1,1.618751618751619e-05,0.0005077839174425353,pH <= 4.21,0
294,682364129632283373580509431665300494998614525119,2,1,1,1.618751618751619e-05,0.0005077839174425353,Brix > 12.53,1
295,477336782581694961294572446833725135167758937360,3,1,2,0.0021043771043771043,0.002031135669770141,moisture <= 86.29,2
296,514025329258926166611226982641428996878062023721,3,1,2,0.0033346283346283347,1.3284959423983016,pH > 4.6,4
297,335487351848184153207836614316819657871865982018,2,1,1,8.093758093758094e-06,0.0005077839174425353,Brix <= 10.08,3
298,339807026696390825523815798916883775674849439623,1,0,1,0.0,0.0030467035046552117,Tit Acid > 0.38,0
299,37775716639446480443771936493018162492062706461,2,1,1,1.618751618751619e-05,0.0010155678348850706,Tit Acid > 0.19,0
300,527059532766714304085954891916145060191909943540,5,2,3,0.008478211603211603,1.134080513411895,pH > 5.01,2
301,398870775018322818270530388810645132978974300981,3,1,2,0.00011331261331261332,0.002031135669770141,pH <= 4.82,3
302,448813672086016113586865331957408449276661454098,2,1,1,8.093758093758094e-06,0.0005077839174425353,Brix > 12.61,3
303,758095011955736098939226360595071174443103751721,2,1,1,2.428127428127428e-05,0.0005077839174425353,Brix <= 12.61,1
304,399023102711590796428179339287425448169444755669,2,1,1,0.0,0.002031135669770141,Brix > 9.39,3
305,646752458251455388435349290593670492217518085015,2,1,1,0.0013557044807044809,0.8823250759984311,Brix > 10.96,4
306,411188159447468770229612531749974582841212665659,3,1,2,0.00020234395234395235,0.004231532645354461,pH <= 4.93,3
307,922586572252774354124392267378067253759929996114,2,1,1,4.046879046879047e-05,0.0005077839174425353,pH > 4.82,3
308,872024544704919922056493202097015134632098036385,5,2,3,0.005285224035224035,0.038193813656969354,Tit Acid > 0.21,1
309,430051081939433362043694565863248812732494907155,3,1,2,0.002072002072002072,1.1853823421221585,pH <= 4.89,2
310,599019335201578896142361365894459009661562918332,3,1,2,0.004168285418285418,0.006347298968031692,Brix <= 12.74,0
311,430183003161371616023747416648166830498763298134,2,1,1,0.0,0.0030467035046552117,Brix > 10.09,2
312,521164696962937281396579031203820241964944508334,3,2,1,0.0,0.0035544874220977472,Tit Acid <= 0.24,1
313,435432251591663184771443986739530685097320043375,2,1,1,1.618751618751619e-05,0.0025389195872126766,Pheno <= 0.56,2
314,435639610782896619166063496621213255249377764557,2,1,1,2.428127428127428e-05,0.0015233517523276059,Pheno <= 0.59,0
315,447961050094219877415622487809132740433958505739,2,1,1,2.428127428127428e-05,0.0010155678348850706,pH <= 4.8,1
316,784154522928793968534439000725342932607966147214,2,1,1,1.618751618751619e-05,0.0005077839174425353,pH > 5.33,3
317,500064764197526873877119658188775008430270189878,3,2,1,0.0,0.004062271339540282,pH <= 4.71,1
318,84512167809889320687753663619642603094491632613,6,2,4,0.10401288526288531,1.0140483778900624,pH > 4.71,3
319,49307678035310162259590137409657341774401842723,2,1,1,0.0010521885521885522,0.0030467035046552117,moisture > 85.46,0
320,532713744300870815677350821848934444001877176071,2,1,1,8.093758093758094e-06,0.0015233517523276059,Pheno > 0.69,0
321,598383822374468668084622614238565013650720079053,2,1,1,8.093758093758094e-06,0.0005077839174425353,Pheno > 0.57,4
322,510370834311025835074897415063219541371286131486,2,1,1,1.618751618751619e-05,0.0005077839174425353,Brix <= 9.25,4
323,852123258902015927841532006232410556410393261447,3,1,2,0.0054228179228179236,1.3338430348545025,pH > 4.93,4
324,51411027190554276040372710135124771703093533811,2,1,1,3.237503237503238e-05,0.0005077839174425353,pH <= 4.27,0
325,527200466659747504002802952462262071522930932312,2,1,1,4.046879046879047e-05,0.0010155678348850706,pH <= 5.38,3
326,527615981893763610496857794219289888517521492446,3,1,2,0.002161033411033411,0.0030467035046552117,Brix <= 10.09,3
327,932221778314891096723198140536411564858533161962,2,1,1,1.618751618751619e-05,0.0005077839174425353,pH > 5.38,2
328,549936121000670782635512708418154682531818293785,2,0,2,0.0,4.156959600830724,Tit Acid <= 0.38,3
329,552082128732713621031558299075311834055380285421,2,1,1,1.618751618751619e-05,0.0010155678348850706,Tit Acid <= 0.27,1
330,582537826255218412350616358088148895236097925109,3,1,2,8.903133903133904e-05,0.0030467035046552117,Brix <= 12.41,1
331,778328208436556174612968741470669967811364075439,2,1,1,8.093758093758094e-06,0.0015233517523276059,moisture <= 87.03,1
332,963108947727994783745996643084981906475258690441,3,1,2,0.0001295001295001295,0.007701389414545118,pH > 4.2,1
333,734688343688369556113059663312243972070074525881,2,1,1,1.618751618751619e-05,0.0005077839174425353,pH <= 5.12,4
334,63961418446748956906977320262974628860158673089,3,1,2,0.0031403781403781406,0.005077839174425353,Tit Acid > 0.32,0
335,641831756543218765207895224121755837839809336518,2,1,1,0.00017806267806267807,0.0005077839174425353,Brix <= 10.54,0
336,644990166847135426657509521055124222533808067750,3,1,2,0.0008822196322196323,1.2459142946852055,Brix <= 13.05,3
337,667544346713655767207480698276097667348824543822,3,1,2,0.013225200725200725,1.19194850625997,pH <= 5.59,3
338,94330844839245431503270651077146112261467374356,2,1,1,8.093758093758094e-06,0.0010155678348850706,pH > 5.26,3
339,863621268533717608572916500724355210461006957865,5,2,3,0.0025171587671587673,0.0025389195872126766,moisture > 87.3,3
340,81486190231966086019325556183891882446407806277,2,1,1,3.237503237503238e-05,0.0005077839174425353,Pheno > 0.85,3
341,709745054719748460616350547026151049340890382119,2,1,1,0.0,0.0015233517523276059,Brix <= 11.25,1
342,998822841126025591137443413266620375147593758556,3,1,2,0.012763856513856515,1.30370588673932,Brix > 10.08,3
343,758560524287726512297488164873179148169457647905,3,1,2,0.012990481740481742,1.2463355541169494,moisture > 77.57,3
344,762230426653986113785175448033231170471128531319,3,1,2,0.008356805231805233,0.014894994911647702,moisture <= 85.86,0
345,895218393837451875401579843634207423751592679453,3,1,2,0.008498445998446,1.612453504875176,moisture <= 90.86,3
346,900052810593849358210706039436426524388025669053,2,1,1,8.093758093758094e-06,0.0005077839174425353,moisture <= 87.3,4
347,945983268971432222548859207615769581540823239463,5,2,3,0.023301929551929553,1.0881249768294652,Pheno > 0.7,3
348,855592484927669116882779498534033413365649723904,3,1,2,0.006025802900802901,1.975987523768728,moisture <= 89.89,3
349,901073044592454542018275862150132430720911856414,2,1,1,0.0,0.0010155678348850706,moisture > 87.79,1
350,882391613375937349039887099612567871453683253732,3,1,2,0.0021003302253302255,0.004062271339540282,moisture > 85.86,1
351,890432466792939110278329111872488737827248724735,2,0,2,0.0,2.820752131944036,Brix <= 10.94,3
352,919658105190845750438077076605021515640992566110,3,1,2,0.002128658378658379,0.0030467035046552117,moisture > 86.82,0
