,Node,Degree,In degree nodes,Out degree nodes,Betweenness centrality,Local reaching centrality,Label
0,100127577578500756600747238918887947924157068191,2,1,1,3.183091418385536e-06,0.0003056979858620296,moisture > 87.99
1,928621589127927934620961952074257259595278295629,98,98,0,0.0,0.0,Class 2
2,1008695164662133922066736660316537427710953069416,2,1,1,1.591545709192768e-05,0.0003056979858620296,pH > 5.46
3,1195054242563020476783971172209845772931465202363,40,40,0,0.0,0.0,Class 4
4,1009935678108774812922520322317363412513239392664,3,1,2,0.007967277820218997,1.6534213537722942,moisture > 82.1
5,478978841060079567412714578692729068041119193452,2,1,1,3.183091418385536e-06,0.0009170939575860888,Tit Acid > 0.34
6,66720490521188455368693219024132734792714896895,3,1,2,0.008027756557168322,1.5933219681238249,Tit Acid <= 0.34
7,1010046219272533096104760473819206042211739377642,2,1,1,3.183091418385536e-06,0.0006113959717240592,pH > 4.16
8,1147257542945440298109815666246017244067397811172,65,65,0,0.0,0.0,Class 0
9,1010765954921083769835515242728462856865164492528,5,2,3,0.00956200662083015,4.267023578910434,Brix <= 12.27
10,297658906941151680714465667105280935546522376372,3,1,2,0.009593837535014006,3.5242909838752103,moisture > 70.75
11,74395099075271920948427425248524259561763509251,2,1,1,1.9098548510313215e-05,0.0003056979858620296,moisture <= 70.75
12,1012117427536195602117069262841250261701294537847,3,1,2,0.0016106442577030811,0.0012227919434481184,moisture > 83.19
13,1230785300360153733677938072203213102690952232747,2,1,1,3.183091418385536e-06,0.0003056979858620296,pH <= 5.07
14,472100551028194121085050670573656480606560629680,2,1,1,3.183091418385536e-06,0.0003056979858620296,pH > 5.07
15,1012727215149894940790962895659570598163314844401,3,1,2,0.0016106442577030811,0.0030569798586202964,pH <= 4.52
16,108373009243295741366769533404488704288210765092,2,1,1,3.183091418385536e-06,0.0009170939575860888,pH > 4.24
17,988013392528626659652324335175339418871169925632,2,1,1,3.183091418385536e-06,0.0006113959717240592,pH <= 4.24
18,101808344089847205341711026940422587424002819247,2,1,1,0.0,0.0006113959717240592,pH > 5.41
19,1023651890920404556613481721436518695026650286074,3,2,1,3.183091418385536e-06,0.002139885901034207,Tit Acid > 0.41
20,1032208343329129818104391639001254550866995358731,2,1,1,6.366182836771072e-06,0.0003056979858620296,Brix <= 10.42
21,171982518954274878349485416184092168691833932185,92,92,0,0.0,0.0,Class 1
22,1034125408886026720768693455143114642292209621397,2,1,1,4.244121891180714e-06,0.0003056979858620296,moisture <= 83.19
23,1036388000295638467941195363813167672284269136557,3,1,2,0.009160937102113574,1.611702989248299,pH > 5.22
24,1098185664989343046012160366509114351270866542056,20,10,10,0.04185006578388933,2.334636149842935,Tit Acid > 0.14
25,905638127712786336374745985074473946082791119647,19,9,10,0.05172438672438674,2.2352543274351535,Tit Acid <= 0.14
26,1036514887168965488969427841042546784303262242115,6,3,3,0.01137318563789152,2.371794827465557,Tit Acid > 0.2
27,1348222192386930823085293057342117903509521856801,5,2,3,0.025287008742891096,2.2817753398815377,Brix > 10.12
28,594622317628574524279625113699187382625387045854,4,2,2,4.138018843901197e-05,0.0012227919434481184,Brix <= 10.12
29,1039644001710311114305057624204376969195728974014,8,3,5,0.009472880061115355,3.510230486623182,Tit Acid <= 0.23
30,177267499210149510724253963525281511412675617616,3,1,2,0.0016010949834479246,2.674955994347629,pH > 4.75
31,484389469237057139332097696486272905589139094295,5,2,3,0.007333842627960275,0.029851408319427192,Brix > 12.27
32,953013916229408958655391420495312068437993458202,2,1,1,0.0,0.0027512818727582667,pH <= 4.75
33,1040952865803721929906599721084890774852026858547,10,4,6,0.0032759315847551143,2.5845868278320383,Pheno > 0.72
34,1168245679253096914676408246803233238004908572028,2,1,1,0.0016488413547237077,2.6858506596909484,moisture <= 89.03
35,280377490082319309235356019026645480419015239982,2,1,1,0.0,0.0009170939575860888,pH <= 5.24
36,511345548392444422312898874708992304597400813363,2,1,1,9.549274255156608e-06,0.0003056979858620296,moisture > 89.03
37,608228183246879578077760169575472540191499544258,2,1,1,6.896698073168661e-06,0.0003056979858620296,pH > 5.24
38,1041607990320541634786254916604009322917316258345,3,1,2,0.0,2.6931279415084317,pH > 4.8
39,14019385422964220106431955229528509600988724262,19,9,10,0.011832187420422713,2.7980279123647254,Tit Acid <= 0.13
40,947349482492510815730367502829189066919667400905,23,8,15,0.10963129191070366,2.58084041341555,Tit Acid > 0.13
41,1049816460094094333888645061217613824805060281861,3,1,2,0.0016106442577030811,0.0018341879151721776,moisture > 87.33
42,1098687669563514264025770275896785710322424675602,2,1,1,3.183091418385536e-06,0.0003056979858620296,pH <= 4.16
43,1050039872014797098968605105705168881060474258636,9,4,5,0.003017570664629488,1.8259846709359258,Pheno > 0.79
44,1285682414325607575257928824784648892310288250819,3,1,2,0.0029889228418640184,1.7798457676483685,Brix > 10.19
45,150913633418211931633209064051558675044205003315,71,71,0,0.0,0.0,Class 3
46,369100123307035486464309348854347714855413374868,2,1,1,0.0,0.0012227919434481184,Brix <= 10.19
47,1053005897269328637543914356245589512143881293866,2,1,1,1.2732365673542144e-05,0.0003056979858620296,Brix > 11.54
48,1053225159289587574630473585300564696766328452081,5,2,3,0.007962503183091418,2.065846864804477,pH <= 4.78
49,1083187108077841047560471393861684567945210031855,2,1,1,9.549274255156608e-06,0.0015284899293101482,pH <= 3.83
50,1433732875319017920889233410878525051225145619206,3,1,2,0.008008658008658008,1.8443668701921694,pH > 3.83
51,1055152064253700014983397201688468879051282735198,1,0,1,0.0,0.0015284899293101482,pH <= 3.8
52,1057181954235649912767741917022286726850621989181,3,1,2,0.0032212885154061623,0.00295508052999962,moisture > 87.59
53,556717024148382109869513597341354447788045885353,3,1,2,0.0016233766233766233,0.0012227919434481184,Brix <= 9.67
54,745989050522176935633753143674321830157873901913,2,1,1,3.183091418385536e-06,0.0003056979858620296,Brix > 9.67
55,1059716611938996712171232427930035324946423782065,5,2,3,0.02010016127663186,1.8350408682020494,pH > 4.87
56,269231723888614229279723687375537811294992806521,10,4,6,0.030760440539852302,2.1117178109502905,pH <= 5.01
57,527059532766714304085954891916145060191909943540,9,4,5,0.0017166412019353195,2.041229942703264,pH > 5.01
58,1061489424500820960357786135378361754191468066629,2,1,1,3.183091418385536e-06,0.0003056979858620296,pH <= 5.13
59,1061646991486779264187939494663666819323664224659,6,2,4,0.005177298192004074,2.7797300534345455,Pheno > 0.65
60,1235093281777064867837067065838604278180603613708,12,4,8,0.009673414820473644,2.4777957254678027,Tit Acid <= 0.22
61,1298003787753353473101990651810802389474599526622,11,4,7,0.04055735930735931,2.2241210552658552,Tit Acid > 0.22
62,532713744300870815677350821848934444001877176071,13,5,8,0.027342808335455392,2.6228543166447387,Pheno > 0.69
63,692974179782182730962353172046240081223686466110,10,4,6,0.0032900963415669294,0.003668375830344355,Pheno <= 0.69
64,1063376167394178517231959089415764487716126423999,3,1,2,0.00326585179526356,0.009130179844412618,moisture <= 86.39
65,271961166575545366369298194527985464851498533780,2,1,1,9.549274255156608e-06,0.0006113959717240592,moisture > 85.69
66,864661859434817211801535702929659248092878784662,3,1,2,0.001674306086070792,0.00588468622784407,moisture <= 85.69
67,1064722700211612430482514847059080720237476709767,5,3,2,1.591545709192768e-06,0.002139885901034207,Tit Acid <= 0.25
68,1065559609151379155284735222300165508439141875420,2,1,1,0.0,0.0006113959717240592,Brix <= 12.19
69,1066695126837972460412703250391981521659112068837,2,0,2,0.0,3.464408005566634,Brix > 10.94
70,1220406208029421398891215352067484920853928295930,3,1,2,6.366182836771072e-06,2.8878694466826955,Pheno > 0.62
71,1233198855909382054836554163560023233305861086389,3,1,2,0.001674306086070792,2.4958489106387627,Pheno <= 0.62
72,1068934606335878284657041109193465099796113944120,6,2,4,0.0018239113827349122,4.1030909157549615,Tit Acid > 0.09
73,1234609601028474526307517299734078385458241720167,5,2,3,0.0022424879042526103,0.011514624134136448,moisture <= 87.47
74,810250382472620947579229958469026811510227057892,5,2,3,0.015926916221033868,4.03579905325278,moisture > 87.47
75,818300426017039898302815959957484483327736126221,8,3,5,0.005118411000763942,2.12954732653604,Tit Acid > 0.23
76,1070714795032507544760283061226237462475556627885,2,1,1,6.366182836771072e-06,0.0003056979858620296,Brix > 9.25
77,1072133880569573387818734585571448733401927403419,2,1,1,0.0,0.0018341879151721776,Pheno <= 0.63
78,1075406946632204589599345773866458656680532336106,2,1,1,9.549274255156608e-06,0.0003056979858620296,moisture <= 83.04
79,1077669966416905743304999731359916793456161937605,2,1,1,0.00016615737203972498,0.0006113959717240592,Brix > 11.55
80,1078664175220452826181491234246161857680321264899,29,12,17,0.12820404677022323,3.0811659102791107,Pheno <= 0.78
81,1086643580389186385648825621674121023303688601056,5,4,1,0.0,0.0033626778444823258,Tit Acid > 0.33
82,1237929490392718556791145078841139784211144198794,33,12,21,0.033374925727866905,3.6807267995904747,Tit Acid <= 0.15
83,124210201951521362978433460778195822768531021450,13,6,7,0.051483851116204044,2.556096601107711,Pheno > 0.75
84,1273287793230791383454031492161695805090720485344,3,1,2,0.0,3.178933603713279,moisture > 83.71
85,1399172750302890602749014230386763788624805271377,3,1,2,0.0039289958407605465,1.5645663915374335,moisture > 86.03
86,1446956719002272568855558192053020875241121414110,9,4,5,0.02055003819709702,2.1046564133526258,Tit Acid <= 0.33
87,217445278825943168102069995246598451560805876405,3,1,2,0.0016010949834479246,1.8089193405586825,moisture <= 83.71
88,227367995596712800920562994603144313835373533341,17,9,8,0.09956800144300142,2.8624859185295914,Tit Acid > 0.15
89,335318240806721174271477968450102581936058348348,2,1,1,0.002387318563789152,0.004636419452240783,moisture <= 87.59
90,469361508389853439729697629011115598507104148813,17,7,10,0.03478110941346236,1.9698062636502889,Pheno <= 0.75
91,556745548993839303618359875554171650973913630373,5,2,3,0.0007978949155419744,2.297127134424179,Pheno <= 0.65
92,827863429825455598856483549254315942383791379018,2,1,1,3.6605551311433666e-05,0.0003056979858620296,moisture <= 86.03
93,1079532077863388015675598726043094095716087110024,3,1,2,0.0,2.322180676024863,pH > 4.01
94,1081449991658252856513521415978250806683185838239,3,2,1,0.0,0.004279771802068414,pH <= 4.2
95,1084251021297852025110799230501022317851666576367,17,8,9,0.0582777883880825,2.5092018024736342,Tit Acid > 0.16
96,1199836470360426511221802180799545605954411878979,2,1,1,3.819709702062643e-05,0.0003056979858620296,pH <= 5.11
97,374326721284177629101053874920649424179999036404,2,1,1,1.591545709192768e-05,0.0003056979858620296,pH > 5.11
98,402551501852144362591499086205357905265844403402,12,5,7,0.028846925133689836,3.480258297653896,Pheno > 0.74
99,520408378444148052535090774918801091096096873386,2,1,1,0.0,0.0006113959717240592,pH <= 5.0
100,850680869277507842791030455333102941280107573886,12,5,7,0.03135079789491554,2.0370477328066783,Pheno <= 0.74
101,866219661844517520440105737257897458358104236613,2,1,1,1.591545709192768e-05,0.0003056979858620296,pH > 5.0
102,1085775669705950178942763954196458192549315056174,2,1,1,6.366182836771072e-06,0.0003056979858620296,Brix <= 10.11
103,108695551173216811220809398532289050002057560322,6,2,4,0.004386459129106188,2.5053674645065787,pH > 5.16
104,1088248199940427074860481752570253273481163547946,2,1,1,9.549274255156608e-06,0.0003056979858620296,Brix <= 11.54
105,1094595865003162816368159976011369561749658044560,3,1,2,0.003230837789661319,0.0037702751589650326,moisture <= 86.4
106,1131648872527188645017649934457144056207019767356,2,1,1,0.0,0.0009170939575860888,Brix > 12.0
107,846755632185994819502766419529589014377703441472,3,1,2,0.00163292589763178,0.0012227919434481184,Brix <= 12.0
108,1095883835307482183503243507799832602731810164034,3,2,1,3.183091418385536e-06,0.0009170939575860888,pH > 4.27
109,1096038671369577883629074723248264891345584653879,2,1,1,0.003684428316781258,2.8977821387094123,moisture > 84.25
110,1369453848931345029933103539410755240102540067288,14,5,9,0.0127859477124183,3.3279302663129204,Tit Acid <= 0.17
111,1097393218549485926510675082709423471387496958586,3,1,2,0.0016615737203972498,1.9610741700622576,pH > 5.34
112,1268834994066267126714212531962537133291228424484,6,3,3,0.007624564977506153,2.7142645650886115,Pheno > 0.73
113,1391436089974438774109670874224736679839775700271,8,3,5,0.013859710550887023,2.0947144789844647,Pheno <= 0.73
114,1097902819252124410424749277226738477057041139957,3,1,2,0.0024228630846277904,1.4234069248961263,moisture <= 86.82
115,1380182139590358552417025152630431100084044367147,3,1,2,0.002486524912995501,1.5509579168907583,Brix <= 11.7
116,340541323206606717962189848457707874412358636521,2,1,1,0.0,0.0009170939575860888,Brix > 11.7
117,1151684139108188992227777924983826154453017451998,15,6,9,0.04970715558950852,1.9035858726833623,Pheno > 0.67
118,341697432501618660556921926132231886294070036119,11,6,5,0.008917961123843476,0.018071845930876986,Pheno <= 0.67
119,624005623655726474188392415263575322370572793900,9,4,5,0.015420327221797812,2.2107870500916014,Pheno <= 0.72
120,1105409889957482382147904612606127892453833009698,11,4,7,0.026026546982429333,2.141385806216788,Tit Acid > 0.24
121,1172701435691027738753025288653525731227105037060,2,1,1,0.0,0.0009170939575860888,moisture <= 88.8
122,1210373156880638738809015111259195620305097167445,2,1,1,3.183091418385536e-06,0.0003056979858620296,moisture > 87.14
123,16769566651221792157231450049135750503234403831,7,3,4,0.05065253374076904,1.8144881307589331,Tit Acid > 0.25
124,458684214623207036791787268277925060784537445389,2,1,1,1.591545709192768e-05,0.0003056979858620296,moisture <= 87.14
125,859064382110568225416817075337968898422716111399,11,4,7,0.028328983108394875,2.2028509629216826,Pheno <= 0.79
126,1105723473131512891662254085371005836659730519156,2,1,1,0.0008212375859434683,0.0006113959717240592,pH <= 4.34
127,393591123370810716850444635655719593158097307974,2,1,1,9.549274255156608e-06,0.0003056979858620296,Brix <= 12.66
128,1109473617230747653753686183885584306394833404050,5,2,3,0.04069582378405908,2.0691300115396443,Brix <= 11.14
129,234441933627735289965281891172678086869419897446,3,1,2,0.020656671759612937,2.2566872459532705,Brix <= 11.0
130,72327627844386361034506630257391595902933838976,3,1,2,0.020099630761395468,2.306764591525916,Brix > 11.0
131,1110286006501510599660955608137587775701142963526,3,1,2,0.004793735676088617,1.4933453920924182,pH <= 5.14
132,1187360199162734959084413965255746161794385449469,3,1,2,0.004854214413037942,1.497701958255316,Brix > 9.8
133,1191406040714575450342483790479019848796166491923,2,1,1,3.183091418385536e-06,0.0009170939575860888,Brix <= 9.8
134,1110568790232959905630420289486502087486430946508,3,1,2,0.0018223198370257193,0.008890716422154029,moisture <= 88.83
135,638254941434425009241185403461603115291452345245,3,1,2,0.0002339572192513369,0.003668375830344355,Brix > 10.76
136,906280855876593157635545003122736618448311494803,2,1,1,0.0,0.002445583886896237,Brix <= 10.76
137,1111357363337626467915817659119738882494459303476,3,1,2,0.002441431117901706,0.0015284899293101482,Brix > 11.15
138,1358888704148725042736779055286277492132079590856,2,1,1,6.366182836771072e-06,0.0003056979858620296,pH > 4.34
139,1115553694368208956972528467008670413289210180059,5,2,3,0.007677616501145913,1.9768181931369246,pH > 4.09
140,1118626552187691828639213513567143945997052379667,2,1,1,0.0,0.0006113959717240592,Brix > 11.27
141,1120903904305686376807339180315138316946784276765,3,1,2,7.639419404125286e-05,0.0036174261660340177,Brix <= 14.55
142,1164855885306831319184235241463983184084645723167,3,2,1,7.95772854596384e-06,0.0012227919434481184,pH <= 4.54
143,116714911697737382047441536574520846070686499340,5,2,3,0.002455755029284441,0.0018341879151721776,pH > 4.54
144,1121632004201231542391068396138858316221906157889,3,1,2,0.0016297428062133944,0.0012227919434481184,pH > 4.91
145,122445604033908938473078190630948358698133432926,2,1,1,1.2732365673542144e-05,0.0003056979858620296,Brix <= 8.88
146,158059194345770793863619625413686121428844757978,2,1,1,6.366182836771072e-06,0.0003056979858620296,Brix > 8.88
147,1121855515770154852410290409449112403849897227292,2,1,1,1.2732365673542144e-05,0.0003056979858620296,moisture <= 78.02
148,1123813039185387328847940573523349697655945745154,2,1,1,9.549274255156608e-06,0.0003056979858620296,moisture <= 77.57
149,1126028288583402792954593979931506693205789403109,3,1,2,0.0074224386724386715,2.5799962394746183,moisture > 87.97
150,41417030911434338004125230269439804259879445302,23,9,14,0.05273374501315679,2.4524324752830893,Pheno > 0.78
151,1136240926082328168886313995259017748045748129998,5,3,2,4.774637127578304e-05,0.0027512818727582667,Pheno <= 0.64
152,1136839288224229192037079574851724102321812647152,3,1,2,0.0,3.69853209519824,moisture > 71.33
153,1459505541307075317069583903840023895269513889914,16,7,9,0.029448476360241064,2.6822216080971657,Pheno <= 0.7
154,945983268971432222548859207615769581540823239463,16,6,10,0.08294160088277736,3.5487850680766044,Pheno > 0.7
155,1138227443913740506058274027235633170219865754505,5,2,3,0.007976827094474153,4.783573325408139,Tit Acid <= 0.21
156,1240466776276824222017031893427282886635574916775,3,1,2,2.8647822765469824e-05,4.5171400658908425,pH > 4.99
157,1447020924709357829249665852444662160906055523561,3,1,2,0.008011841100076394,2.2052960901471135,pH <= 4.99
158,114189968201256226507441273296838158293259521330,2,1,1,2.8647822765469824e-05,0.0003056979858620296,Brix <= 11.32
159,114288386783329094858692510758135355427541248708,9,3,6,0.004451022833375774,4.960405709039751,pH <= 5.16
160,526047352448732854443680809168250965427631523486,2,1,1,1.2732365673542144e-05,0.0003056979858620296,pH <= 4.98
161,531509356863486706025982339411863302481303645584,5,2,3,0.005396400984636279,2.0762351244389983,Brix <= 9.91
162,825792580619614131751020977051041803762036359722,2,1,1,4.774637127578303e-06,0.0003056979858620296,pH > 4.98
163,892641096355272269845543261565401309761422639964,5,2,3,0.0032021899668958492,4.421522837192075,Brix > 9.91
164,114417977878880735374340839360950363312987496982,2,0,2,0.0,4.923991431344427,pH > 4.41
165,149702574861862781640897559315302020438679772497,3,2,1,3.5014005602240894e-05,0.002445583886896237,Tit Acid <= 0.09
166,189078214289674865644358532974550465226588841649,10,4,6,0.029820791953144896,2.6762099134311437,Tit Acid <= 0.2
167,978240363515654852646980169628775635440671287094,2,1,1,6.403318903318903e-05,0.0003056979858620296,moisture <= 84.25
168,1153417406874620875477637336154330185777695478090,2,1,1,0.0,2.1437176381491945,moisture > 83.75
169,1308425805814366873910502507832070611603025885708,8,3,5,0.021362257024021735,2.271367926424744,pH <= 5.17
170,1162337874571585539831538580960191134516666783601,3,1,2,0.003195823784059078,2.876898798788909,Brix <= 10.18
171,30919185512656709085427375044464017285309148467,3,1,2,0.0032563025210084035,3.1112800744186777,moisture > 88.43
172,993991903056697954683126545050747895764612025582,2,1,1,3.183091418385536e-06,0.0003056979858620296,moisture <= 88.43
173,1295960832990774694751889211742613816364524779343,2,1,1,0.0008291953144894321,0.0006113959717240592,Brix <= 12.83
174,1378614789273833145083975234257509177572274484264,2,1,1,3.183091418385536e-06,0.0003056979858620296,Brix > 12.83
175,1170214555683808590798108500479380442752191698990,2,1,1,3.183091418385536e-06,0.0003056979858620296,pH <= 3.64
176,1171835655071792071813825078588763100056718271652,3,1,2,0.004917876241405653,1.5597714837585412,moisture > 86.4
177,384165568604620773602991426913274488186991046821,5,2,3,0.013793926661573721,1.661828391738748,Tit Acid <= 0.28
178,665763256441369002694541083156400242042163903310,4,2,2,9.549274255156608e-06,0.0015284899293101482,Tit Acid > 0.28
179,1177156324774343630180289433853750706070064958051,3,1,2,0.0033104150751209573,1.8096770390294306,Brix <= 12.14
180,1441546845436194822669682670264288322714084069402,2,1,1,3.183091418385536e-06,0.0012227919434481184,pH > 4.44
181,212185387160784274421368300677720187383376528580,3,1,2,0.003370893812070283,1.805418608025273,pH <= 4.44
182,1179307966795094331079735577613054875122803952110,3,1,2,0.0032531194295900177,3.0918462346529303,moisture > 82.41
183,459710425420134478586444207626522368596952442246,2,1,1,0.003319964349376114,3.312959361254965,Brix > 11.66
184,924260886117282214700599762932344738097292877517,3,1,2,0.0,2.919745717879377,Brix <= 11.66
185,1179748637485698376043865247738973137077653953684,3,1,2,0.007586898395721925,1.715214448043081,moisture <= 87.79
186,431500440665982291877861151163819974354623898398,5,2,3,0.011798658857482386,1.739059169186903,Tit Acid <= 0.26
187,494127393420143926044921388078061355092756508432,3,2,1,9.549274255156608e-06,0.0006113959717240592,Tit Acid > 0.26
188,1181504877852149003572992857613830846974179669922,2,1,1,1.1140819964349376e-05,0.0003056979858620296,moisture > 90.86
189,1183095263998325490897206552893338214712556693392,3,1,2,0.006614463967405144,1.9272949374484318,moisture > 78.02
190,119301423525731187517967532278343815174362677337,5,2,3,0.01215198200492318,2.0670635740044143,moisture > 84.3
191,277838038800051883697216638760365392108712858277,4,2,2,9.055895085306849e-05,0.0009170939575860888,moisture <= 84.3
192,1184410121112144387797236283446958142415121041379,3,1,2,0.0016615737203972498,1.6931749101528832,Brix > 10.57
193,1185884278337992742856356075127001292993529548115,2,1,1,0.0,0.0018341879151721776,Pheno > 0.68
194,190373535843181436202405661235606844945328054365,3,1,2,0.0016106442577030811,0.005655412738447548,moisture > 84.91
195,390689622405582358421658391175588029757496401462,3,1,2,0.003307231983702572,1.6572745712273884,moisture <= 84.91
196,1187477454179323680983549483249500748948298802333,2,1,1,0.0,0.0006113959717240592,Brix <= 10.24
197,1189551739223268419220815657881647951820121867840,3,1,2,0.0,1.9209668790009422,moisture <= 87.29
198,1189792097719093374113470465457590323968574810250,3,1,2,1.9098548510313215e-05,0.003515526837413341,moisture > 86.58
199,51411027190554276040372710135124771703093533811,3,2,1,3.183091418385536e-06,0.0015284899293101482,pH <= 4.27
200,1190853731658875778202568083794893815496314613179,2,1,1,9.549274255156608e-06,0.0009170939575860888,Brix <= 10.28
201,1192868523207543668395459480650423217230777079348,9,3,6,0.01128724216959511,2.9941040319994707,Pheno <= 0.82
202,516601140442069092777768951925603503757731753522,3,1,2,0.006455309396485867,2.0438729567389653,pH <= 5.21
203,550186777857029450128845246677781164439655510056,2,1,1,3.183091418385536e-06,0.0003056979858620296,Brix <= 8.59
204,7502286575422847517785813269994352158580699271,3,1,2,0.0016774891774891775,2.447552492088868,pH > 5.21
205,86370669055240235722387130102705015071151204184,3,1,2,0.0016106442577030811,2.684197784556023,Brix > 8.59
206,478988701995746220836729620311416045687869066757,11,4,7,0.02856081826670062,2.2671893795676055,Pheno <= 0.8
207,937787711282178832864130665432839185535877783171,6,4,2,4.45632798573975e-05,0.0015284899293101482,Pheno > 0.8
208,1193196437593980692700981826145293546974506066116,2,1,1,3.183091418385536e-06,0.0003056979858620296,Brix > 11.95
209,1194551982078116586257583268357029260884961365376,3,1,2,0.0033804430863254393,1.4604430422794388,moisture <= 88.22
210,1279844039703918997884095703828528221818683790498,3,1,2,0.005054749172396231,1.5520416288056689,Brix <= 11.06
211,248438178818573091628497364426317176239089470187,2,1,1,0.0,0.002139885901034207,Brix > 11.06
212,120106183051182237607263674391451144360743383182,2,1,1,3.183091418385536e-06,0.0003056979858620296,Brix > 11.47
213,1201960535396958139467932502500117568201874538629,2,1,1,4.774637127578304e-06,0.0003056979858620296,moisture <= 81.93
214,1202281202334859649737464243089883719203118393624,3,1,2,0.0016647568118156354,1.6107400405928334,moisture <= 88.03
215,1203872029766058782594935404742863438421894564308,4,2,2,0.011943489517018931,2.6806017562559687,pH > 5.3
216,1204858209925897222925216697928866248786228823046,2,1,1,3.183091418385536e-06,0.0009170939575860888,Brix <= 9.49
217,1205127994515811685416031375712848919611548453188,2,1,1,3.183091418385536e-06,0.0012227919434481184,Brix > 11.4
218,1217884912855473183701012549888874898408190828252,3,1,2,0.019759464391817333,1.6575290845663062,moisture <= 87.09
219,175545555491426056943858551402811694992155579583,3,1,2,3.819709702062643e-05,2.5455765757539264,pH > 4.38
220,590081565621587515431066707911531937749332074909,3,1,2,0.0016361089890501656,1.6375998848956297,pH <= 4.38
221,1222606835484573781895929093124951088888598819094,3,1,2,0.005944423223834989,1.7019724309353252,pH <= 5.09
222,273764106271060204315148621639829800440158926075,3,2,1,1.2732365673542144e-05,0.0009170939575860888,pH <= 4.87
223,1224567414088547328557731984150793443944476995218,3,1,2,0.0057327476445123505,0.018907420425566538,Pheno > 0.58
224,478745528338872669317150855026491283540954864552,2,1,1,3.183091418385536e-06,0.0009170939575860888,moisture > 85.93
225,710175824836010444184892302931160987938305871337,3,1,2,0.004144385026737968,0.011871271784308815,moisture <= 85.93
226,1229270261957475338282130882941763708382891556644,8,3,5,0.017616819455054746,3.677293835391143,Brix > 12.41
227,1386691901693956780169467586885890447209598951478,6,3,3,0.0215491575418046,4.153406549262839,Tit Acid <= 0.19
228,1408106403902609088300230351177243711723390226416,3,1,2,0.0016106442577030811,0.002445583886896237,pH <= 4.63
229,37775716639446480443771936493018162492062706461,4,2,2,4.138018843901197e-05,0.0009170939575860888,Tit Acid > 0.19
230,734789052732733492679768827994020669856403584340,2,1,1,2.228163992869875e-05,0.0003056979858620296,pH > 4.63
231,1229347079255250543408299586035634797376275693713,2,1,1,2.228163992869875e-05,0.0006113959717240592,moisture <= 87.33
232,1233132830027618210488125789898061842476585378738,3,1,2,0.0016679399032340208,0.0030569798586202964,pH > 4.5
233,1373061612195441060822163496952186533463429827750,2,1,1,3.183091418385536e-06,0.0003056979858620296,pH <= 4.65
234,378345503555160919056301248624329192801274796057,2,1,1,3.5014005602240894e-05,0.0012227919434481184,pH > 4.65
235,22299444265181951376006874183015402110349795518,4,2,2,6.366182836771072e-06,2.7586289203909113,pH > 4.95
236,637235121675842374134504446661437525158405032722,5,2,3,0.006576266870384518,1.8442561632353176,pH <= 4.95
237,32042953284261613606020448332040450324879250118,3,1,2,0.0006382098293862999,0.007132953003447357,Brix <= 11.4
238,1297638582765570971178304788286998986277071689200,2,1,1,0.0005379424497071555,2.179156695983872,moisture > 73.04
239,130910188948100984394040813486364150271025483147,3,1,2,0.0016138273491214667,0.0012227919434481184,moisture > 90.15
240,30573465449542453962392756566305676467799910962,2,1,1,9.549274255156608e-06,0.0003056979858620296,moisture <= 73.04
241,618197223437240795592093463959982804028395488473,3,1,2,0.0032531194295900177,1.6546123279374694,pH <= 5.46
242,642112573656807165703313015619896940450767607790,13,5,8,0.015995670995670994,2.555012208421815,Tit Acid <= 0.18
243,965426097790400467695380693242664745427138996783,3,1,2,0.0,2.0371507018576893,moisture <= 90.15
244,999449005863449650043698603557860460414697697202,6,3,3,0.005015491044902809,2.19942999710832,Tit Acid > 0.18
245,1235811037754722330169136314640271062392362040553,2,1,1,6.366182836771072e-06,0.0003056979858620296,moisture > 84.44
246,1236601761975753926008705690228766962109600732316,3,1,2,0.003313598166539343,3.4292030099219226,moisture <= 90.22
247,1237768951997144473834154670164614157341606161958,3,1,2,0.000754392666157372,1.8892666211274227,moisture > 87.66
248,1237770383266825801746566633527271572152532879110,2,1,1,5.0929462694168576e-05,0.0003056979858620296,moisture <= 81.78
249,1247566892266719794547618626797282432638165600122,2,1,1,4.244121891180714e-06,0.0003056979858620296,pH <= 5.06
250,1279277118470248049491918220694835009436228081531,2,1,1,0.0,0.0018341879151721776,moisture <= 87.41
251,241821156710561854083889010000595558158541903007,3,1,2,0.0015369026398438163,2.692967903000519,moisture > 87.41
252,420882672450711953685778385299921576823656385950,2,1,1,1.591545709192768e-05,0.0003056979858620296,pH <= 5.08
253,506604351442154279907754485682302558197425074816,2,1,1,0.0008053221288515406,0.0006113959717240592,Brix > 12.19
254,53202860733200024026023219245065271666901395804,2,1,1,0.0,0.0006113959717240592,pH <= 5.04
255,539841963763980928303120942267934660259153369307,5,2,3,6.366182836771072e-05,2.2409445542306243,pH > 5.1
256,601036295719308094984942580025946222301410524376,2,1,1,4.244121891180714e-06,0.0003056979858620296,Brix > 11.69
257,780612758154117084460367677723484213453251002058,2,1,1,1.591545709192768e-05,0.0003056979858620296,Brix <= 11.69
258,790232291106810786815988388775216340577894965987,3,2,1,3.183091418385536e-06,0.0009170939575860888,pH > 5.06
259,824241047817046928909952306547648190264910408440,3,1,2,0.003373228079110433,0.002445583886896237,pH > 5.08
260,859937142169726300085497970880016369278523345795,2,1,1,0.0004026610644257703,0.0009170939575860888,Brix > 11.05
261,894406717605448330614352030725481623211153227930,5,2,3,0.014774318818436466,1.7351431098926597,pH <= 5.1
262,928509115978080756874805192981247263366374112929,2,1,1,0.0,0.0006113959717240592,Brix <= 11.05
263,954228811239594033357502191266040141914096422930,2,1,1,0.0,0.0006113959717240592,pH > 5.04
264,1238887112417446101404296194779980453583779100111,2,1,1,0.0,0.0003056979858620296,pH > 4.3
265,763212543587750217808106594112871041545025736785,13,4,9,0.01699876920465156,4.521768312099153,Tit Acid > 0.12
266,775650655566268222195963750769541160664287144256,10,4,6,0.02984625668449198,2.6710722965042746,Tit Acid <= 0.12
267,201652953103342019199086917760886428083210198503,2,1,1,0.0008053221288515406,0.0006113959717240592,Brix > 10.7
268,414546368116635972257913228794527802843288302412,2,1,1,4.138018843901197e-05,0.0003056979858620296,Brix <= 10.7
269,1245546997581260022666443016827456462869670114213,2,1,1,6.366182836771072e-06,0.0003056979858620296,pH > 5.59
270,1258695038462974189879422216805616477505618952611,2,1,1,3.395297512944571e-05,0.0003056979858620296,pH <= 4.84
271,1259167502758551106923889701345919405938228082832,3,1,2,0.00163292589763178,0.0012227919434481184,moisture <= 83.16
272,395731007300951607834617656877083264467555186849,2,1,1,6.366182836771072e-06,0.0003056979858620296,pH <= 4.53
273,816444493355278027039499392361696127114757517768,2,1,1,2.228163992869875e-05,0.0003056979858620296,pH > 4.53
274,1261334357936830640476404426357306600714899852612,2,0,2,0.0,4.40545907553242,pH > 3.8
275,1276810453078600040270949478387573991456066005105,2,1,1,3.183091418385536e-06,0.0006113959717240592,Pheno <= 0.66
276,1277909709325778818096916785111124886777034086674,3,1,2,0.005045199898141075,1.7027691739134672,Brix > 10.28
277,176645373172273420828484620192855170075859691379,6,2,4,0.005745480010185893,1.6959116349786958,pH <= 4.09
278,128473428555430558759210035008794577138276117746,3,1,2,0.012012987012987014,3.0776420697153393,moisture > 84.03
279,14309284403762313679097497980508542052383149142,3,1,2,0.008845811051693405,3.3335480207763215,pH > 4.08
280,1433594937437577767459313955442898362810758392346,3,1,2,0.003230837789661319,0.0025474832155169135,pH <= 4.08
281,1284978948073345825605388131209667487410163646462,2,1,1,1.591545709192768e-05,0.0003056979858620296,Tit Acid > 0.35
282,1285400216682292034217017949375179487406489325125,5,2,3,2.8647822765469824e-05,3.3687371143243006,pH > 4.23
283,1389845597516703181812529879143029582723265017342,3,2,1,0.0,0.004891167773792474,pH <= 4.6
284,514025329258926166611226982641428996878062023721,6,2,4,0.0064521263050674816,3.1070361308315397,pH > 4.6
285,521164696962937281396579031203820241964944508334,7,4,3,0.007995925642984467,1.8598884082768605,Tit Acid <= 0.24
286,1286209433107264406126985252848197299495082577717,3,1,2,0.004029793735676089,0.005375189584740689,moisture > 81.78
287,26262123209431038897219755297914681850831133132,3,1,2,0.002428698752228164,0.0035664765017236785,Tit Acid <= 0.39
288,365732877566896957786168909862900480790881506400,2,1,1,3.183091418385536e-06,0.0003056979858620296,Tit Acid > 0.39
289,1290065798498006283115205286854288258557225666014,2,1,1,6.366182836771072e-06,0.0003056979858620296,moisture <= 84.03
290,1294092558534500641731851223402440377639362886552,3,1,2,0.0032913165266106443,0.0063687080387922835,Pheno <= 0.77
291,853478642427592708294455255610961227479352588215,2,1,1,6.366182836771072e-06,0.0006113959717240592,pH <= 4.5
292,1294715536720538980835333471735000550737165570301,10,4,6,0.02469707580001698,1.7250533567202524,Tit Acid > 0.17
293,712979755472354743209619751389951397039451283185,2,1,1,1.4323911382734912e-05,0.0003056979858620296,Brix > 12.5
294,129704127352994401699893847168374652078269544461,3,1,2,0.004831932773109244,0.013909258356722349,Pheno > 0.56
295,709522578723862305770069290517222256340509360109,3,1,2,0.00323720397249809,0.006674406024654313,Brix > 9.49
296,1375399875471741495431433422769494526722335326932,3,1,2,0.0032053730583142346,1.7934899688174886,moisture > 86.48
297,658708370755683951460474484090534411729195159179,6,2,4,0.0065539852304558185,2.3195616864060997,Tit Acid <= 0.41
298,963108947727994783745996643084981906475258690441,6,2,4,0.02291984975808505,1.701238764676542,pH > 4.2
299,964730454324481872235560795563542447156877787575,3,1,2,0.009663865546218488,0.016472026471532362,moisture <= 86.48
300,1300965428224098083584542786860272113371821123277,6,2,4,0.0016711229946524064,2.0137787954649524,Brix <= 11.74
301,1305666649656113560151968379093810989428501882760,2,1,1,6.366182836771072e-06,0.0003056979858620296,moisture <= 86.58
302,816382306734624810576405438803019166342408188903,5,2,3,0.011697860962566845,2.0641290038056503,Brix > 11.14
303,1306138064337432474499170095541317153206206943103,2,1,1,3.183091418385536e-06,0.0003056979858620296,Pheno <= 0.55
304,1311510893297959856194204946534932167635744976686,3,1,2,0.0,2.55684956266436,pH <= 4.58
305,448296988200843630369419911163555237315285978193,3,1,2,0.0,1.9608715722665766,pH > 4.58
306,1424762211720957756902873119791486838317798019688,2,1,1,6.366182836771072e-06,0.0003056979858620296,moisture <= 91.13
307,1450496375163395839721635662846378703407596478081,2,1,1,3.183091418385536e-06,0.0003056979858620296,moisture > 91.13
308,1312310949554463399287816576824423061306594586155,2,1,1,0.0,0.0003056979858620296,moisture <= 88.58
309,1312986247376770026891594613458202606065655299089,3,1,2,0.0016265597147950089,0.0012227919434481184,moisture > 86.15
310,46121443854123449818305240124542215855970144189,2,1,1,1.2732365673542144e-05,0.0003056979858620296,moisture > 87.67
311,663781710571459125592606766961433391470250812967,2,1,1,3.183091418385536e-06,0.0003056979858620296,moisture <= 87.67
312,1316070098940975335983536277503008973870132410966,2,1,1,0.006256896698073169,3.3112343511918865,Pheno <= 0.85
313,1321661511126510148468737894218929275593525496686,5,4,1,3.183091418385536e-06,0.0067253556889646515,Tit Acid <= 0.1
314,1323794905782010694128521093358605841916050899389,3,1,2,0.015043608352431882,3.6245966169564556,pH <= 5.22
315,1325458169293780423054928281750956229617652864043,2,1,1,6.366182836771072e-06,0.0006113959717240592,Brix <= 11.16
316,1325733371643065873511166849431582337192314336293,2,1,1,0.0,0.0009170939575860888,Brix <= 11.77
317,1333219697471816788031688559363630137582736901080,2,1,1,0.0016615737203972498,2.688575378720537,moisture > 88.78
318,1346673667641844161734751361815534013472078259808,3,1,2,0.0016042780748663102,1.6772727700131485,pH > 4.88
319,227471317491477077470632925016243188221345114154,2,1,1,6.366182836771072e-06,0.0003056979858620296,Brix <= 10.57
320,349178031356020426119547840078637389178404387440,2,1,1,2.228163992869875e-05,0.0003056979858620296,moisture <= 82.1
321,1351945955060965088498220515028432149719863926292,7,4,3,0.0032356124267888973,0.00677630535327499,Tit Acid <= 0.11
322,1455795230845802777918013132903327314833495343484,3,1,2,0.0016233766233766233,0.0018341879151721776,moisture <= 87.95
323,407056331533418999769103757709019114533594828372,2,1,1,1.4323911382734912e-05,0.0003056979858620296,moisture > 87.95
324,1353822741269520035130178384551776432885805993826,3,1,2,0.009479246243952126,2.2379670767218127,Brix > 10.86
325,269691972290611216355971523650200205864002053328,5,2,3,0.0032547109752992104,2.4442885233366067,pH > 4.78
326,1354825744255726205556083956412964533251576769463,2,1,1,0.0,0.0006113959717240592,Brix <= 10.85
327,1359621009229284716935205666829144925176447621033,3,1,2,0.009861217214158391,1.825863472966092,pH <= 5.26
328,1441655350341890941614520753917652373824477167080,16,7,9,0.12540398735251673,1.9421614592090184,Tit Acid <= 0.16
329,1360559255423146372610111696158536068419027788613,3,1,2,0.001612235803412274,0.004891167773792474,Tit Acid > 0.31
330,1366081949616292208744512455843331458351167972218,2,1,1,4.774637127578304e-06,0.0003056979858620296,Brix <= 10.02
331,915776135173734635733624239408657390277171150826,2,1,1,3.183091418385536e-06,0.002139885901034207,Brix > 10.02
332,1360987528353510078407126011059862124220640303007,2,1,1,6.366182836771072e-06,0.0003056979858620296,moisture > 88.22
333,654230765831910832364613877599787643313442292830,3,1,2,0.004080723198370257,3.7587123461659204,pH > 5.45
334,871743260620983391299633283929437246488336693221,3,1,2,0.0,2.683020578969166,pH <= 5.45
335,1371805337674407898275711717712071806982918337857,2,1,1,0.0,0.0003056979858620296,Brix > 12.74
336,1373347432538866619505116869199797637013813938826,3,1,2,0.0016997708174178762,1.5170547180038745,pH <= 4.19
337,434980552850454240155732100423678165018043794092,3,1,2,0.0016567990832696716,1.8595519417127724,Tit Acid <= 0.31
338,1376497140004679734339259226798810791228870351218,3,1,2,0.0016265597147950089,0.002445583886896237,pH <= 4.35
339,753285963304559782798606382896415182230593406892,2,1,1,1.2732365673542144e-05,0.0009170939575860888,Brix <= 12.71
340,941926540123526191836434904407525120308136818518,2,1,1,3.183091418385536e-06,0.0003056979858620296,Brix > 12.71
341,1379058987082517188855604202157317621401514448201,3,1,2,0.0032626687038451742,0.0025474832155169135,moisture <= 85.5
342,306230200128400215091437277381736612343064418837,3,1,2,0.001639292080468551,0.0012227919434481184,moisture <= 84.44
343,1381877576296208000589113195431761217086740083800,3,1,2,0.001715686274509804,3.3386744747989257,pH <= 4.88
344,582537826255218412350616358088148895236097925109,7,3,4,0.0016345174433409727,0.0018341879151721776,Brix <= 12.41
345,1383045789014029471710781731961807727090016907641,3,1,2,6.366182836771072e-06,6.0879182089503185,pH > 4.19
346,425950537542314473811980022578319522088182865590,3,1,2,0.0016711229946524064,5.337306809526485,moisture > 71.9
347,836004564429252488813951020922595834652797430924,2,1,1,3.183091418385536e-06,0.0003056979858620296,moisture <= 71.9
348,1385144062140078162558193597519163875851254985677,2,1,1,3.183091418385536e-06,0.0012227919434481184,pH <= 3.75
349,1385360150908778659458855169047708112669345349686,3,1,2,0.004765087853323148,3.1690881426368325,Brix > 12.14
350,401849052094181080436076126418024594358650184652,3,1,2,0.0048287496816908585,3.3853765879578703,Pheno <= 0.68
351,1390565464165431138895261137125313236449929179655,2,1,1,5.167218402512519e-05,0.0003056979858620296,Brix > 10.54
352,492035860147612048863774204249020635399895060879,2,1,1,1.2732365673542144e-05,0.0003056979858620296,pH > 5.4
353,91599817836758983322403205915490085382451484041,2,1,1,6.366182836771072e-06,0.0003056979858620296,pH <= 5.4
354,1392316096367518349866276269041745411265815645303,2,1,1,3.183091418385536e-06,0.0006113959717240592,moisture <= 82.41
355,1394568216230848767204470860692931071065523515688,2,1,1,0.0,0.0003056979858620296,pH > 4.96
356,592428781388308123196323159466738623004719793134,3,1,2,0.003989474577709872,1.6849093323691502,pH <= 5.31
357,929669822954466368781570939272616348968828867860,2,1,1,3.183091418385536e-06,0.0003056979858620296,pH > 5.31
358,315335336196243816662376563521226888334928581913,3,1,2,0.0,2.782603793919796,Pheno > 0.63
359,542587181052035438973110002434304419085007660766,12,4,8,0.011837916984975808,2.822478842047757,Tit Acid > 0.1
360,567905170835719895825752398031504061926099469998,2,1,1,6.0478736949325185e-05,0.0003056979858620296,Brix > 11.13
361,73528199168407328596459160988808329839271151930,3,1,2,0.0,2.806021914695017,Brix <= 11.55
362,80977916570598044051307388330326018563402609497,2,1,1,1.9098548510313215e-05,0.0003056979858620296,Brix <= 11.13
363,14031532405571743634624912828080204254597625767,5,2,3,0.005573593073593073,2.297146859372755,pH > 5.17
364,218436665745879481361124138397795723708762687582,2,1,1,6.366182836771072e-06,0.0015284899293101482,Brix > 11.11
365,249340605757856364358704160057685008403663371408,3,1,2,0.005624522536287242,2.290765406926532,Brix <= 11.11
366,1405245601027660786125741477698000295615911050563,3,1,2,0.001769798828622359,1.6020449203250795,Pheno > 0.66
367,1406934934120251625612133221223658485807342486992,3,1,2,0.0017411510058568881,2.7026575270349698,Brix <= 9.39
368,1440335382918687438535224440716847939872691334081,7,3,4,8.9126559714795e-05,3.100365143507303,Pheno <= 0.76
369,708974994663940473356047250801743764720458270635,11,4,7,0.010406056361938715,2.123389342205995,Pheno > 0.76
370,249003664736387491624155332854530965807626226736,2,1,1,3.183091418385536e-06,0.0006113959717240592,Brix <= 12.93
371,405736712887949729994537148344124757311748951967,2,1,1,3.183091418385536e-06,0.0006113959717240592,Brix > 12.93
372,1410734861225614826957669090340285827285767854465,2,1,1,6.366182836771072e-06,0.0003056979858620296,pH <= 5.33
373,1412576102911718948876177982029926049863052796532,3,1,2,0.0016647568118156354,2.1554267759827694,pH <= 4.01
374,680535130715851981657662742361007073578382992253,6,2,4,0.009788006111535524,2.3786828139880405,Pheno > 0.64
375,1420855393752826397476723276676391429574104930872,6,2,4,0.005243612596553772,1.7035305857879621,Pheno <= 0.81
376,485815315589978273009080559932448325972849944858,3,1,2,0.001923648247177659,1.9500669812460698,Brix <= 11.47
377,1430171494093856240910218570031376795030403015577,2,1,1,6.366182836771072e-06,0.0003056979858620296,Brix > 11.25
378,99189174290857686170068194283183457263752368832,3,1,2,0.008909472880061116,3.6999548390748256,Brix > 11.77
379,228629933351857911586206065499486498215331247225,2,1,1,6.366182836771072e-06,0.0003056979858620296,moisture <= 86.15
380,1436202689171701946909271625929195695076075885598,2,1,1,9.549274255156608e-06,0.0003056979858620296,pH > 5.03
381,1438091065233049884654636408694725210269131422155,3,1,2,0.0,4.073652273095499,moisture <= 90.27
382,1439157627400264411376365335601922955910930314266,6,3,3,0.01114877769289534,2.661233582963988,Tit Acid > 0.29
383,1439464955386705651918278339040352366460275629035,3,1,2,0.006918979713097361,2.2654961464272168,pH > 4.76
384,1458924405464063515228681003248175979732942947901,3,1,2,0.00876782531194296,1.5769330242378148,Pheno <= 0.84
385,441846762623701445615353709565100611078497231403,2,1,1,0.0008053221288515406,0.0006113959717240592,moisture > 85.34
386,765592453115146640633038007468437610469124266623,2,1,1,6.366182836771072e-06,0.0003056979858620296,Pheno > 0.84
387,946469583164485345996914984787775396258236729112,5,2,3,0.04361737119090061,1.9763511324689589,Pheno > 0.81
388,1442471073064452470232609811104347494213769547374,2,1,1,0.0,0.0006113959717240592,pH > 4.77
389,594305372998091615540369694577692187104963013296,2,1,1,6.366182836771072e-06,0.0006113959717240592,pH <= 4.22
390,937403765014084242515053459650118407781227299456,3,1,2,0.005788451744334098,3.3340619048234172,pH > 4.22
391,586207411123808759976655522970393173686357326840,3,1,2,0.004809651133180545,2.195453804961917,moisture > 86.39
392,144753638059622628806861579012763468719693272140,3,1,2,0.0011697860962566844,2.173417025419752,pH > 4.89
393,227433626263115702977273694017012744327541066228,11,4,7,0.04459314786520669,2.322506957222006,Tit Acid > 0.11
394,144809051277064866348764398810469181053394007309,3,1,2,0.001143260334436805,1.7578820026506363,Brix > 10.18
395,1450476829875396438424828153392846571565048083844,5,2,3,0.004450492318139376,1.7409917079384238,pH > 4.21
396,672332599721112324355867062173889692788689330655,5,2,3,0.003243570155334861,0.004993067102413151,Brix > 11.6
397,738760784115287950683012939167376161343781682445,5,2,3,0.00936836855954503,2.015372999942147,Brix <= 11.6
398,1452446365081073637376382947680247931996315856640,2,0,2,0.0,2.4643442926497743,pH <= 4.41
399,729975338000531002608581950108499682523859359044,3,1,2,0.0016965877259994906,2.1996045001077857,pH > 3.64
400,829704520395958485353761463372577207502431999063,2,1,1,3.183091418385536e-06,0.0006113959717240592,Brix > 9.89
401,846018207069443445824676653278782823962292569938,2,1,1,9.549274255156608e-06,0.0003056979858620296,Brix <= 9.89
402,1458076921483226212222179841257653452184508102471,3,1,2,0.0017347848230201172,1.6894159048289223,Tit Acid <= 0.32
403,756297897021004223295909235636130446250906912491,3,1,2,0.0007756132756132756,1.6096891808619878,moisture <= 87.16
404,933756729222335092793216951610122983063076054863,3,1,2,0.0010260164671929378,1.8139913036668849,moisture > 87.16
405,231181347083149241591051667437200970404733148699,3,1,2,0.00883148714031067,1.6989643731487707,Brix > 10.88
406,678579799782929757328525100603297462527014574466,2,1,1,0.0,0.0009170939575860888,Brix <= 10.88
407,281426929804447327036007344464597780150040855481,2,1,1,3.183091418385536e-05,0.0003056979858620296,moisture > 87.09
408,427126028839433250346413229071032180560802580904,3,1,2,0.001597911892029539,2.483498472735837,Pheno > 0.6
409,638999303984683282978144816741753938944344811040,3,1,2,0.0035666539343009933,1.6539039841388958,Brix > 10.24
410,982119225243198413857918285177710587335623039998,2,1,1,0.0012764196587725998,1.5921828484102383,Pheno <= 0.6
411,147220081334260120105087561777675422179271749170,2,1,1,3.183091418385536e-06,0.0003056979858620296,Brix > 14.55
412,147838599967036647767250856295121242570311435892,2,1,1,9.549274255156608e-06,0.0003056979858620296,Brix <= 10.73
413,147860641729304468009300889158500163508655895047,2,1,1,4.774637127578304e-06,0.0006113959717240592,Tit Acid > 0.27
414,155678121349909014470255436144758383989656087361,3,1,2,0.0016695314489432137,3.0932577650127584,pH <= 4.97
415,367099616260871060401207309336881793103785394644,5,2,3,0.01325916730328495,2.1853444277730856,pH <= 4.23
416,158006808477048146119712560775676464229610946645,2,1,1,0.020982408114761056,2.662729776204385,moisture > 88.83
417,168415065240224630780472188045407892356497831458,2,0,2,0.0,4.811505399488092,pH > 4.57
418,77353867812668850131408293361928626704531012269,3,1,2,0.001674306086070792,2.3851107362284933,moisture > 90.27
419,174271960952921865813684006619033525921336705719,2,1,1,6.366182836771072e-06,0.0003056979858620296,moisture > 90.22
420,314614043712472267125975167775062166135256544588,6,2,4,0.009539724980901452,2.7640739693796776,Brix > 11.74
421,185103442522261858230366081949197606782253884162,2,1,1,9.549274255156608e-06,0.0006113959717240592,moisture <= 87.63
422,958163794447047216498529922731709520086222296765,2,1,1,6.366182836771072e-06,0.0003056979858620296,moisture > 87.63
423,184042335899791461426488807510371112447431944346,2,1,1,0.0016615737203972498,2.0553615772413796,moisture > 83.04
424,428337588300963676283958377694182998226752112550,11,4,7,0.01305704099821747,2.1717457257314186,Tit Acid <= 0.29
425,527795530990880509741751660020745654720659278304,2,1,1,0.0,0.0012227919434481184,Brix <= 10.4
426,70097823383559155292237270959669303832201318693,2,1,1,1.9098548510313215e-05,0.002802231537068605,Brix > 10.4
427,203750686558893426443500162351677490977428178699,2,1,1,1.591545709192768e-05,0.0003056979858620296,pH <= 4.77
428,49347967898784251663502104009378972690807490172,3,1,2,0.0034281894576012224,1.8321043660169403,Brix > 11.16
429,622598769667804494137629575765384734315163051315,2,1,1,3.183091418385536e-06,0.0006113959717240592,pH <= 5.34
430,222419773618386845891899880742668937047644568917,3,1,2,0.001620193531958238,0.002445583886896237,moisture > 86.29
431,578945386731621121066454334364960673642618887059,2,1,1,6.366182836771072e-06,0.0006113959717240592,moisture > 88.42
432,842184217077156338155513443582429322008237542243,2,1,1,3.183091418385536e-06,0.0006113959717240592,moisture <= 88.42
433,223301908176508386263497230968104390606799181686,2,1,1,3.183091418385536e-06,0.0003056979858620296,Brix <= 12.53
434,550900080730997224834446510634211792471714437226,2,1,1,4.138018843901197e-05,0.0003056979858620296,moisture <= 83.75
435,519777900835371833776025079820909718923781039584,3,1,2,0.0011124904507257448,1.975586887504304,Brix <= 9.07
436,828775283361771303587038709567202104514239918046,3,1,2,0.0,2.5437487631087423,Brix > 9.07
437,228019555939926981970315585528929600110199697385,3,1,2,0.00487012987012987,2.2203366930252115,moisture > 87.03
438,229972872122238022294053787842320819454257767747,3,1,2,0.007150814871403107,1.5213556275892162,Pheno > 0.55
439,233514774849967560490339294820318542895453405013,3,1,2,0.007897249809014515,2.8204035934122484,Brix <= 10.96
440,730234002799503929354326135447071420040396685365,5,3,2,1.9098548510313215e-05,0.002139885901034207,Pheno > 0.82
441,529052830235461479044787831355661166693965463200,2,1,1,5.729564553093965e-05,0.0003056979858620296,moisture <= 86.92
442,703668007945996384365861252154344570501987254,3,1,2,0.020663037942449707,2.5487961339045113,moisture > 86.92
443,245684303784715268847019968464377942558661637315,3,1,2,0.0032531194295900177,3.731332920736638,Pheno > 0.59
444,447664605078082614813690311881368433506160665928,2,1,1,6.366182836771072e-06,0.0003056979858620296,moisture <= 75.78
445,53037336007018060845255065814220928603774890448,3,1,2,0.0033104150751209573,2.807841443341562,moisture > 75.78
446,249030341527809223937443731273754878739806237380,3,1,2,0.0032276546982429335,0.00295508052999962,moisture > 89.89
447,92385814583727389261064792543667060556475889632,2,1,1,3.183091418385536e-06,0.0003056979858620296,pH <= 4.91
448,249110337371457120017112949762945326549801735612,1,0,1,0.0,0.0003056979858620296,Brix > 14.18
449,253922261890430999205267669682022302178631037563,7,3,4,0.0016711229946524064,0.003668375830344355,pH > 5.12
450,553321909181445851254685111699728044475715130522,2,1,1,1.9098548510313215e-05,0.0003056979858620296,Brix <= 10.15
451,722229397895839030194791373029104320396624651181,2,1,1,0.0,0.0012227919434481184,Brix > 10.15
452,792138996825164763961216789503536691928458420803,2,1,1,0.0008148714031066972,0.0025984328798272518,Brix <= 11.95
453,620172969906758026226147666334760385832884834260,3,1,2,0.0,2.1518750060056924,Brix <= 10.86
454,269985999564410014550431691212670634837935007440,3,1,2,0.009571555895085307,1.8876845747763715,Brix <= 12.3
455,300983639737910739802524555895054313638023200021,2,1,1,6.366182836771072e-06,0.0012227919434481184,Brix <= 9.99
456,747218799105151263391358894316127464133990799415,3,1,2,0.009628851540616247,1.8515833674077296,Brix > 9.99
457,27179484041025161924231712556228612435607858596,3,1,2,0.0033804430863254393,1.9557838249771216,pH > 3.75
458,27422612100181239534411966719283935950524810046,3,1,2,0.009511077158135981,1.972149732898644,pH > 4.52
459,732610074641892084255741575753171295594674388450,2,1,1,3.183091418385536e-06,0.0003056979858620296,Brix > 12.3
460,279844694759439463736615635979304852026338846030,2,1,1,0.0,0.0006113959717240592,Brix > 13.05
461,290708621864237198637923132626927314502717658789,3,1,2,0.004873312961548255,0.005247815423964842,moisture > 81.93
462,406952273850868512233800771899513292114191770765,2,1,1,6.366182836771072e-06,0.0006113959717240592,moisture > 85.5
463,292400524884163105224827227731917750178259041571,3,1,2,0.001597911892029539,2.5430530942754563,moisture > 87.29
464,585831330631376020196651220005217173751910922427,3,1,2,0.0,2.4996705863402684,moisture > 88.03
465,295169623190637535697252647558642683553516168235,2,1,1,6.366182836771072e-06,0.0003056979858620296,moisture <= 85.46
466,296304533169904882159656994347407226046691508770,2,1,1,0.0008180544945250828,0.0006113959717240592,moisture <= 87.89
467,720329263601063491910068131525238271659391111009,2,1,1,1.591545709192768e-05,0.0003056979858620296,Brix > 10.39
468,303427651036728708663818405774914844390855506685,4,1,3,0.006413929208046855,1.6420602741713852,pH <= 5.41
469,314481329406331221346824442324578186096521671941,3,1,2,0.004831932773109244,0.006623456360343976,pH > 5.29
470,879777753611004235437037181589738421603931041991,2,1,1,0.0016424751718869366,1.7989584881948588,pH <= 5.29
471,305375912038333805752515593852256379678918604245,5,2,3,0.0016265597147950089,0.004891167773792474,pH <= 4.21
472,524154621817565150120355719824994035584820083007,2,1,1,0.0,0.002139885901034207,Brix > 10.73
473,305811601668605127738709791870361684645933119236,4,2,2,6.366182836771072e-06,0.0027512818727582667,pH <= 5.3
474,682364129632283373580509431665300494998614525119,2,1,1,6.366182836771072e-06,0.0003056979858620296,Brix > 12.53
475,477336782581694961294572446833725135167758937360,3,1,2,0.0016233766233766233,0.0012227919434481184,moisture <= 86.29
476,319140071811162213839601178949725747265937900250,2,1,1,6.366182836771072e-06,0.0003056979858620296,pH > 4.35
477,734688343688369556113059663312243972070074525881,3,2,1,9.549274255156608e-06,0.0006113959717240592,pH <= 5.12
478,323501158067356708446644817391766772531723404326,2,1,1,9.549274255156608e-06,0.0003056979858620296,moisture <= 71.33
479,335487351848184153207836614316819657871865982018,2,1,1,3.183091418385536e-06,0.0003056979858620296,Brix <= 10.08
480,339807026696390825523815798916883775674849439623,1,0,1,0.0,0.0018341879151721776,Tit Acid > 0.38
481,546653801915536301208311775824645299363981753644,3,1,2,0.001620193531958238,0.004279771802068414,pH > 4.84
482,371739936680869327078953217181565699680811996622,2,1,1,3.183091418385536e-06,0.0006113959717240592,Brix <= 11.15
483,391982844921355186603221206326351299498079751719,3,1,2,0.0016615737203972498,2.192749014414249,pH > 5.13
484,398870775018322818270530388810645132978974300981,3,1,2,0.0016233766233766233,0.0012227919434481184,pH <= 4.82
485,448813672086016113586865331957408449276661454098,2,1,1,3.183091418385536e-06,0.0003056979858620296,Brix > 12.61
486,758095011955736098939226360595071174443103751721,2,1,1,9.549274255156608e-06,0.0003056979858620296,Brix <= 12.61
487,399023102711590796428179339287425448169444755669,2,1,1,0.0,0.0012227919434481184,Brix > 9.39
488,646752458251455388435349290593670492217518085015,2,1,1,0.001116204057380528,1.941372029111016,Brix > 10.96
489,411188159447468770229612531749974582841212665659,3,1,2,0.003230837789661319,0.0025474832155169135,pH <= 4.93
490,922586572252774354124392267378067253759929996114,2,1,1,9.549274255156608e-06,0.0003056979858620296,pH > 4.82
491,505999025934227433070684395903690609806529295127,3,1,2,0.0016010949834479246,2.1588818776520564,pH > 5.09
492,567209310890593965756633184996901447968879846381,2,1,1,2.7056277056277056e-05,0.0003056979858620296,moisture > 88.58
493,872024544704919922056493202097015134632098036385,7,3,4,0.007548701298701299,1.7105714045406606,Tit Acid > 0.21
494,415754621359783031657838047419150732649916013635,2,1,1,0.0,0.0009170939575860888,moisture > 87.89
495,430051081939433362043694565863248812732494907155,3,1,2,0.0016074611662846958,1.9579745232589367,pH <= 4.89
496,525723564076991957814207642175112511237589635538,2,1,1,1.2732365673542144e-05,0.0006113959717240592,pH <= 4.3
497,599019335201578896142361365894459009661562918332,3,1,2,0.0070903361344537815,1.4231022298155487,Brix <= 12.74
498,430183003161371616023747416648166830498763298134,2,1,1,0.0,0.0018341879151721776,Brix > 10.09
499,43452168768946262147339360491301268668105166433,3,1,2,0.011955691367456073,2.92408334338248,Brix <= 12.58
500,435432251591663184771443986739530685097320043375,2,1,1,0.0,0.0015284899293101482,Pheno <= 0.56
501,435639610782896619166063496621213255249377764557,2,1,1,6.366182836771072e-06,0.0009170939575860888,Pheno <= 0.59
502,597240793788279097482678786121035081124008541581,2,1,1,3.183091418385536e-06,0.0003056979858620296,pH > 4.86
503,443389976761155973029773453867667404493374875938,2,1,1,6.366182836771072e-06,0.0003056979858620296,pH > 4.47
504,447961050094219877415622487809132740433958505739,2,1,1,9.761480349715645e-06,0.0006113959717240592,pH <= 4.8
505,45454144829668979566464121012617294258704128459,3,1,2,0.005649987267634327,0.006521557031723299,pH <= 4.76
506,754026118938031224988125148765921218165529643700,3,1,2,0.004045709192768017,0.0035410016695685102,Tit Acid <= 0.35
507,471182560395889809391890418388711827050521108419,2,1,1,1.1140819964349376e-05,0.0003056979858620296,Brix > 9.81
508,473948672628948527453482997300682640189535562799,3,1,2,0.011895212630506748,2.802130070257363,Brix > 10.42
509,881892323562918618664253700929288373810782101092,2,1,1,3.183091418385536e-06,0.0003056979858620296,Brix > 12.58
510,784154522928793968534439000725342932607966147214,2,1,1,6.366182836771072e-06,0.0003056979858620296,pH > 5.33
511,500064764197526873877119658188775008430270189878,3,2,1,0.0,0.002445583886896237,pH <= 4.71
512,84512167809889320687753663619642603094491632613,6,2,4,0.021638655462184873,2.247731523898245,pH > 4.71
513,765160675239293187214236736151236639614461866158,2,1,1,2.228163992869875e-05,0.0006113959717240592,Pheno <= 0.58
514,49307678035310162259590137409657341774401842723,2,1,1,0.001852559205500382,2.3434849207421062,moisture > 85.46
515,598383822374468668084622614238565013650720079053,2,1,1,3.183091418385536e-06,0.0003056979858620296,Pheno > 0.57
516,510370834311025835074897415063219541371286131486,2,1,1,6.366182836771072e-06,0.0003056979858620296,Brix <= 9.25
517,852123258902015927841532006232410556410393261447,3,1,2,0.00017507002801120448,2.80903412315116,pH > 4.93
518,877819209072785552115350148780062842504871798295,3,1,2,0.006426661573720397,1.9122729736838309,moisture > 83.16
519,527200466659747504002802952462262071522930932312,2,1,1,9.549274255156608e-06,0.0006113959717240592,pH <= 5.38
520,527615981893763610496857794219289888517521492446,3,1,2,0.00163292589763178,0.0018341879151721776,Brix <= 10.09
521,932221778314891096723198140536411564858533161962,2,1,1,6.366182836771072e-06,0.0003056979858620296,pH > 5.38
522,675798974509199504744858822352403035082544952027,3,1,2,0.004283963585434173,3.9604427639401827,Brix <= 9.81
523,534709524930951729371238217181686707831915445583,2,1,1,0.0,0.0018341879151721776,pH > 4.43
524,536239403739219137460654683273249635163189085689,3,1,2,7.95772854596384e-06,2.353978082187049,pH > 4.97
525,747423452227744247161295534790989887946002677415,3,1,2,0.0,3.2132041847999875,Brix <= 10.72
526,952313422186425994786064188240471309864615073355,3,1,2,0.0,2.679595256895131,Brix > 10.72
527,542825319342297292723743196560552512888927232153,2,1,1,0.0,0.0018341879151721776,moisture <= 87.97
528,9434725571691239350454780324621362091686499662,2,1,1,3.183091418385536e-06,0.0018341879151721776,Brix > 10.11
529,549936121000670782635512708418154682531818293785,2,0,2,0.0,6.7354574920429116,Tit Acid <= 0.38
530,552082128732713621031558299075311834055380285421,2,1,1,6.366182836771072e-06,0.0006113959717240592,Tit Acid <= 0.27
531,778328208436556174612968741470669967811364075439,2,1,1,3.183091418385536e-06,0.0009170939575860888,moisture <= 87.03
532,63961418446748956906977320262974628860158673089,3,1,2,0.0017952635599694424,2.1323028292138844,Tit Acid > 0.32
533,641831756543218765207895224121755837839809336518,2,1,1,0.00012573211102622867,0.0003056979858620296,Brix <= 10.54
534,709745054719748460616350547026151049340890382119,4,2,2,0.0015885748238689413,0.0018341879151721776,Brix <= 11.25
535,644990166847135426657509521055124222533808067750,3,1,2,0.0,2.2343861754600316,Brix <= 13.05
536,831216051963128111059865728113512938730483047553,3,1,2,0.00808505220269926,1.5330731879708732,pH <= 4.47
537,667544346713655767207480698276097667348824543822,3,1,2,0.009800738477209065,1.7944290850439022,pH <= 5.59
538,94330844839245431503270651077146112261467374356,2,1,1,3.183091418385536e-06,0.0006113959717240592,pH > 5.26
539,993220505241451504412699202801575240176639188473,2,1,1,1.9098548510313215e-05,0.0003056979858620296,moisture <= 87.66
540,688009881189776860885492402720533814068979872590,2,1,1,3.183091418385536e-06,0.0006113959717240592,moisture <= 88.78
541,800560659014047820531377890316189255887764550923,2,1,1,0.0,0.0006113959717240592,moisture > 85.67
542,823286059127633130789160561879566804412099978626,2,1,1,2.0690094219505983e-05,0.0003056979858620296,moisture <= 85.67
543,700582572100114243821835096343921902813338864061,2,0,2,0.0,3.383473531464038,pH <= 4.57
544,863621268533717608572916500724355210461006957865,5,2,3,0.001810330192683134,0.0015284899293101482,moisture > 87.3
545,752858087326450445032258197887178540403040319630,2,1,1,7.95772854596384e-06,0.0003056979858620296,pH <= 5.03
546,81486190231966086019325556183891882446407806277,2,1,1,7.95772854596384e-06,0.0003056979858620296,Pheno > 0.85
547,837370564306014830643982857390690332587885059971,4,2,2,0.0008403361344537815,0.0006113959717240592,Pheno > 0.77
548,72535786789298985323937217325617450602766526739,3,1,2,0.0016010949834479246,2.4114002004814696,Brix <= 11.27
549,998822841126025591137443413266620375147593758556,3,1,2,0.009689330277565572,1.8222150784192295,Brix > 10.08
550,758560524287726512297488164873179148169457647905,3,1,2,0.009743442831678125,1.8024362502191196,moisture > 77.57
551,762230426653986113785175448033231170471128531319,3,1,2,0.006469633307868602,0.008967140918619537,moisture <= 85.86
552,895218393837451875401579843634207423751592679453,3,1,2,0.0031926406926406927,3.2623464377343434,moisture <= 90.86
553,81304423054701568083146293284761118367616354415,3,1,2,0.02345673117731942,1.9049980903209753,Brix > 10.85
554,900052810593849358210706039436426524388025669053,2,1,1,3.183091418385536e-06,0.0003056979858620296,moisture <= 87.3
555,855592484927669116882779498534033413365649723904,3,1,2,0.0031671759612936085,2.867073101135829,moisture <= 89.89
556,862394938095338021287746232263177249790935630992,2,0,2,0.0,4.5239819956961975,Brix <= 14.18
557,901073044592454542018275862150132430720911856414,2,1,1,0.0,0.0006113959717240592,moisture > 87.79
558,882391613375937349039887099612567871453683253732,3,1,2,0.0016217850776674306,0.002445583886896237,moisture > 85.86
559,884340906982724731661178697235768485858531437166,3,1,2,0.009431499872676344,2.342079250232666,pH <= 4.43
560,890432466792939110278329111872488737827248724735,2,0,2,0.0,3.5203694207934473,Brix <= 10.94
561,919658105190845750438077076605021515640992566110,3,1,2,0.0034324335794924028,3.7052286099749683,moisture > 86.82
