,Node,Degree,In degree nodes,Out degree nodes,Betweenness centrality,Local reaching centrality,Label
0,100355699843047465067178463041045147428005271050,2,1,1,0.0,0.004517021086405383,pH <= 5.35
1,928621589127927934620961952074257259595278295629,51,51,0,0.0,0.0,Class 2
2,1017599768786735048464572964633161441725643638065,3,1,2,0.004208456243854474,1.4137015436707676,Brix > 11.07
3,78929301915197830927275187076306325025229731185,5,2,3,0.03071779744346116,1.4224479676160835,moisture > 85.06
4,896638563637099557646821839675178859389402911103,5,2,3,0.0031071779744346116,0.004968723195045922,moisture <= 85.06
5,1039644001710311114305057624204376969195728974014,2,1,1,0.0,0.0067755316296080744,Tit Acid <= 0.23
6,171982518954274878349485416184092168691833932185,28,28,0,0.0,0.0,Class 1
7,1040952865803721929906599721084890774852026858547,6,2,4,0.009085545722713865,2.1789067807658427,Pheno > 0.72
8,1047079156029689005341523092134779784460317576067,8,3,5,0.02385447394296952,1.4596796653700066,Brix <= 10.47
9,1329907479955885769404976189624453827909930603141,2,1,1,0.0,0.003161914760483768,moisture <= 89.16
10,165644917979433045096778224233875896118673456949,9,3,6,0.024975417895771877,2.5123293723501003,Brix > 10.47
11,880906355044111715629274031211066252453008613553,2,1,1,3.9331366764995083e-05,0.0004517021086405383,moisture > 89.16
12,1043498684616219590488399871951774367965750228378,3,1,2,0.0029301868239921336,2.5623093307320013,Brix > 10.62
13,1419060244117965495412029413417760007259458564683,2,1,1,1.9665683382497542e-05,0.0013551063259216148,Brix > 12.85
14,454790473848408353201751758466431519326046225362,3,1,2,0.004267453294001967,2.5502543270180342,Brix <= 12.85
15,1043903249785310589747781639007621873485197433743,2,1,1,5.899705014749262e-05,0.0004517021086405383,pH > 3.96
16,104647647231053249401406611198140964809741850694,2,1,1,0.0,0.0009034042172810766,pH > 4.94
17,1237265994102648826715151826126075249469806378295,3,1,2,0.02133398885611275,1.6252304843450722,Brix <= 9.28
18,1254609139350073366408358171331618191603227032344,3,1,2,0.0008685676827269749,1.6885073376870696,moisture > 87.96
19,533735226380233132854068706426231558692711368887,2,1,1,0.0,0.004065318977764845,Brix > 9.28
20,647291524414615663051227101926122920500217886230,2,1,1,0.0,0.0022585105432026916,moisture <= 87.96
21,1064722700211612430482514847059080720237476709767,7,1,6,0.02776794493608653,3.2470898252020777,Tit Acid <= 0.25
22,314857879696376171423608953820670847835654884757,6,2,4,0.015063913470993118,2.3968649273637332,pH > 4.73
23,427126028839433250346413229071032180560802580904,8,2,6,0.014591937069813175,2.9931916548725996,Pheno > 0.6
24,730699573538352139692191826491930980328647852283,5,2,3,0.006096361848574238,0.052623295656622715,pH <= 4.73
25,818300426017039898302815959957484483327736126221,3,1,2,0.003018682399213373,0.004517021086405383,Tit Acid > 0.23
26,982119225243198413857918285177710587335623039998,7,2,5,0.006086529006882989,0.011292552716013456,Pheno <= 0.6
27,1072133880569573387818734585571448733401927403419,3,1,2,0.0030678466076696164,0.0036136168691243064,Pheno <= 0.63
28,472369138574493424906956306166243931374203715470,2,1,1,3.9331366764995083e-05,0.0013551063259216148,moisture <= 87.38
29,527229230963226377677302819108613815361637862950,2,1,1,3.9331366764995083e-05,0.0004517021086405383,moisture > 87.38
30,1077766440587969615108921971347658648400205152291,2,1,1,0.00011799410029498524,0.0009034042172810766,Brix > 11.65
31,1195054242563020476783971172209845772931465202363,24,24,0,0.0,0.0,Class 4
32,1078664175220452826181491234246161857680321264899,5,2,3,0.00983284169124877,0.027358091046661936,Pheno <= 0.78
33,1275507691733625221918920970171520347395180116926,3,1,2,0.007079646017699115,0.020176027519277374,moisture <= 84.82
34,1306243074544277973079447867401076076051415204594,2,1,1,0.0,0.0036136168691243064,moisture > 84.82
35,150913633418211931633209064051558675044205003315,33,33,0,0.0,0.0,Class 3
36,1082048259293728021355499586353010410433592618954,2,1,1,1.9665683382497542e-05,0.0013551063259216148,moisture > 87.02
37,108373009243295741366769533404488704288210765092,2,1,1,1.9665683382497542e-05,0.006323829520967536,pH > 4.24
38,1084251021297852025110799230501022317851666576367,9,4,5,0.009714847590953786,0.015357871693778303,Tit Acid > 0.16
39,1222606835484573781895929093124951088888598819094,2,1,1,3.9331366764995083e-05,0.0004517021086405383,pH <= 5.09
40,505999025934227433070684395903690609806529295127,2,1,1,3.9331366764995083e-05,0.0004517021086405383,pH > 5.09
41,520138005686279619394342881595163568954742703111,3,1,2,0.003264503441494592,0.005420425303686459,Brix > 10.17
42,535831275340651710061061031017769768325599227142,2,1,1,0.0,0.0009034042172810766,Brix <= 10.17
43,108695551173216811220809398532289050002057560322,3,1,2,0.01631268436578171,2.093822480143678,pH > 5.16
44,1226999407028174264856564375386384119756490121214,3,1,2,0.01766961651917404,2.3669178434338516,pH > 5.35
45,1092810479860852010962744361185020914673156703389,2,1,1,0.0,0.0022585105432026916,moisture <= 85.23
46,110446626826307389898629859452394264952855631815,2,1,1,0.0006489675516224188,0.0009034042172810766,Tit Acid <= 0.3
47,1105409889957482382147904612606127892453833009698,5,2,3,0.006037364798426746,0.021380566475652146,Tit Acid > 0.24
48,1147257542945440298109815666246017244067397811172,21,21,0,0.0,0.0,Class 0
49,1202281202334859649737464243089883719203118393624,2,1,1,0.0,0.00813063795552969,moisture <= 88.03
50,585831330631376020196651220005217173751910922427,3,1,2,0.003126843657817109,0.0018068084345621532,moisture > 88.03
51,1110286006501510599660955608137587775701142963526,3,1,2,0.02135693215339233,1.310931682929713,pH <= 5.14
52,1343515086664158599009117579743337965292112566537,2,1,1,9.832841691248771e-05,0.0004517021086405383,Brix <= 9.68
53,782674491907339821905242295837302284454880144691,3,1,2,0.02261553588987217,1.2887322886564359,Brix > 9.68
54,1113779388840611510372127596828511344205954348770,3,1,2,0.0030285152409046216,0.0036136168691243064,Brix <= 11.07
55,1321823324268434578341877527271903385845936619321,2,1,1,3.9331366764995083e-05,0.0013551063259216148,pH <= 5.36
56,185223566590935545347045369920413506073103251168,2,1,1,3.9331366764995083e-05,0.0004517021086405383,pH > 5.36
57,1115553694368208956972528467008670413289210180059,2,1,1,1.9665683382497542e-05,0.0022585105432026916,pH > 4.09
58,1131648872527188645017649934457144056207019767356,2,1,1,1.9665683382497542e-05,0.0004517021086405383,Brix > 12.0
59,114288386783329094858692510758135355427541248708,2,1,1,9.832841691248771e-06,0.004968723195045922,pH <= 5.16
60,1149998277852801788316901209141149759511765893741,2,1,1,7.866273352999017e-05,0.0004517021086405383,moisture > 84.18
61,117019745706298747085662111636172380469599575690,2,1,1,1.9665683382497542e-05,0.0004517021086405383,moisture > 89.81
62,1185884278337992742856356075127001292993529548115,2,1,1,0.0,0.004968723195045922,Pheno > 0.68
63,1208199532003260704580883667179978148803167350089,6,2,4,0.03516224188790561,2.3438467508557883,moisture > 84.12
64,1294092558534500641731851223402440377639362886552,6,2,4,0.043618485742379545,2.434184826079435,Pheno <= 0.77
65,1346673667641844161734751361815534013472078259808,3,1,2,0.014355948869223206,2.0478612365537314,pH > 4.88
66,1381877576296208000589113195431761217086740083800,2,1,1,0.0,0.007678935846889151,pH <= 4.88
67,837370564306014830643982857390690332587885059971,6,2,4,0.013372664700098328,1.9388425854208717,Pheno > 0.77
68,1217802002027660884953098701453035691707860350981,5,2,3,0.0030678466076696164,0.004968723195045922,moisture > 87.84
69,1333219697471816788031688559363630137582736901080,2,1,1,7.866273352999017e-05,0.0004517021086405383,moisture > 88.78
70,688009881189776860885492402720533814068979872590,2,1,1,3.9331366764995083e-05,0.0009034042172810766,moisture <= 88.78
71,1220406208029421398891215352067484920853928295930,4,1,3,0.017620452310717797,3.6193538606929487,Pheno > 0.62
72,521164696962937281396579031203820241964944508334,6,2,4,0.017227138643067845,3.058276980009963,Tit Acid <= 0.24
73,1225024790285814687889763212275675076256066146102,2,1,1,0.00011799410029498524,0.0004517021086405383,moisture <= 88.04
74,478988701995746220836729620311416045687869066757,7,3,4,0.03365781710914454,2.824583804997884,Pheno <= 0.8
75,937787711282178832864130665432839185535877783171,7,3,4,0.00495575221238938,0.009034042172810767,Pheno > 0.8
76,1233198855909382054836554163560023233305861086389,4,1,3,0.032271386430678464,2.1167190188621556,Pheno <= 0.62
77,642112573656807165703313015619896940450767607790,8,3,5,0.01376597836774828,2.507790320194037,Tit Acid <= 0.18
78,999449005863449650043698603557860460414697697202,8,3,5,0.06688298918387414,2.4811232095303035,Tit Acid > 0.18
79,14019385422964220106431955229528509600988724262,11,4,7,0.04942641756801048,2.0142850879336907,Tit Acid <= 0.13
80,947349482492510815730367502829189066919667400905,8,4,4,0.04965585054080629,1.861412332907314,Tit Acid > 0.13
81,1237768951997144473834154670164614157341606161958,2,1,1,0.0,0.004517021086405383,moisture > 87.66
82,1237929490392718556791145078841139784211144198794,9,4,5,0.03113077679449361,1.8493771867380382,Tit Acid <= 0.15
83,522873472964201129250458866849716223113042415957,3,1,2,0.014965585054080629,2.008456452329731,moisture <= 89.81
84,1240466776276824222017031893427282886635574916775,6,2,4,0.038898721730580135,1.6668195934712533,pH > 4.99
85,1350391265422783703599338866183580972591905410299,2,1,1,0.0,0.0013551063259216148,moisture <= 87.12
86,483521324189472157760032913504717226978232212120,2,1,1,9.832841691248771e-05,0.0004517021086405383,moisture > 87.12
87,124210201951521362978433460778195822768531021450,2,1,1,1.9665683382497542e-05,0.0013551063259216148,Pheno > 0.75
88,1250059311300753794030521829379652543833568345626,3,1,2,0.00896755162241888,0.013249928520122457,moisture > 86.35
89,402551501852144362591499086205357905265844403402,3,1,2,0.006116027531956735,0.005269857934139613,Pheno > 0.74
90,850680869277507842791030455333102941280107573886,2,1,1,0.0,0.0022585105432026916,Pheno <= 0.74
91,532713744300870815677350821848934444001877176071,7,3,4,0.030868567682726975,1.8864931902606006,Pheno > 0.69
92,692974179782182730962353172046240081223686466110,4,3,1,0.0002753195673549656,0.0027102126518432296,Pheno <= 0.69
93,1267223687777369789844656014428253412555264842238,2,0,2,0.0,3.2496378031427517,Brix > 11.03
94,1450476829875396438424828153392846571565048083844,3,1,2,0.004326450344149459,3.0505338035895675,pH > 4.21
95,305375912038333805752515593852256379678918604245,2,1,1,1.9665683382497542e-05,0.006323829520967536,pH <= 4.21
96,1268506014654445549021678142540716813522721295938,2,1,1,0.00011799410029498524,0.0004517021086405383,moisture > 73.5
97,521715610441294927518937479846970148498395371549,5,2,3,0.005948869223205506,0.027930247050939952,Brix <= 11.43
98,985159174247860258406427835362282688395764253852,4,2,2,1.9665683382497542e-05,0.0036136168691243064,Brix > 11.43
99,1276652225189126286803484037803337464902497064563,5,2,3,0.003205506391347099,0.003161914760483768,Brix <= 8.9
100,1401224623284831405418148142254403173729462867479,2,1,1,0.0,0.0013551063259216148,moisture > 88.04
101,1276810453078600040270949478387573991456066005105,3,2,1,1.9665683382497542e-05,0.005420425303686459,Pheno <= 0.66
102,596499728078599072988654454424180549206663945954,3,1,2,0.01311701081612586,1.7317976324637037,moisture <= 87.02
103,129704127352994401699893847168374652078269544461,2,0,2,0.0,3.670086558151565,Pheno > 0.56
104,1308425805814366873910502507832070611603025885708,6,2,4,0.012763028515240905,1.9411591656820968,pH <= 5.17
105,227367995596712800920562994603144313835373533341,11,4,7,0.03284169124877089,1.3028248287486632,Tit Acid > 0.15
106,28125022736064914567959995496975776029608762290,6,3,3,0.028869223205506393,1.6353866814825841,moisture > 88.53
107,881150987650182980348089052019840262082136192240,9,3,6,0.04956735496558506,2.0312690182774715,moisture <= 88.53
108,1314331802978425843698051881164280856494209548044,3,1,2,0.0,0.04080375714719529,Brix <= 10.65
109,1441655350341890941614520753917652373824477167080,9,4,5,0.004975417895771878,0.011292552716013456,Tit Acid <= 0.16
110,1317131137490315402024263102743181549566993569198,3,2,1,0.0,0.005420425303686459,Brix <= 10.68
111,1330305355836427141310510120453409936363787527595,3,1,2,0.048515240904621434,3.1058275516835656,pH <= 4.31
112,1332817049989096526625739202212078353018225607016,2,1,1,3.9331366764995083e-05,0.0004517021086405383,moisture <= 84.66
113,1334397803982614334162389130667683854243451195325,3,1,2,0.032055063913470995,2.082042848505251,moisture <= 87.28
114,1351945955060965088498220515028432149719863926292,12,7,5,0.009400196656833825,0.03523276447396199,Tit Acid <= 0.11
115,227433626263115702977273694017012744327541066228,22,7,15,0.13244837758112094,1.9194079116684706,Tit Acid > 0.11
116,1351790565781538588069137276152767980617598773955,3,1,2,0.007964601769911504,1.9651794431304368,moisture > 85.23
117,624005623655726474188392415263575322370572793900,5,2,3,0.003048180924287119,0.00813063795552969,Pheno <= 0.72
118,1747132756190080726694698293394103700627759963,2,1,1,0.0,0.0018068084345621532,Brix > 9.93
119,176674819211903920805174053136212153900221587233,2,1,1,5.899705014749262e-05,0.0009034042172810766,Brix <= 9.93
120,556056145676242252196935790480711865714256718197,3,1,2,0.00344149459193707,0.0018068084345621532,moisture <= 84.99
121,609655441806685391040905382276868544877293772511,2,1,1,0.0,0.004517021086405383,moisture > 84.99
122,1359621009229284716935205666829144925176447621033,2,1,1,0.0,0.0027102126518432296,pH <= 5.26
123,1365155039725429132679548442176646454137333102322,3,1,2,0.003205506391347099,0.043438686114265095,moisture <= 86.35
124,469361508389853439729697629011115598507104148813,3,1,2,0.0004523107177974435,0.02642457335547149,Pheno <= 0.75
125,1372376111315669287850628471356060458106754933825,2,1,1,1.9665683382497542e-05,0.0004517021086405383,Brix <= 10.22
126,137287800202512868294706791040107241621141460475,2,1,1,0.0009636184857423795,0.0009034042172810766,Tit Acid > 0.3
127,1379336804504195168527439016680973129436620664677,3,1,2,0.003048180924287119,0.009937446390091843,pH <= 4.03
128,859937142169726300085497970880016369278523345795,2,1,1,1.9665683382497542e-05,0.004065318977764845,Brix > 11.05
129,928509115978080756874805192981247263366374112929,2,1,1,3.9331366764995083e-05,0.0009034042172810766,Brix <= 11.05
130,1386691901693956780169467586885890447209598951478,4,1,3,0.005604719764011799,2.546431561643699,Tit Acid <= 0.19
131,1394568216230848767204470860692931071065523515688,3,1,2,0.003146509341199607,0.0018068084345621532,pH > 4.96
132,62989471618559573922611006272235636181965616957,2,1,1,5.899705014749262e-05,0.0004517021086405383,pH <= 5.15
133,762057201204484973216621467133581478507860929147,2,1,1,5.899705014749262e-05,0.0004517021086405383,pH > 5.15
134,1432151297989965308569793308740501598397808013233,2,1,1,4.9164208456243856e-05,0.0004517021086405383,pH > 5.27
135,344581972631449126940182600109632035145516236651,3,1,2,0.04465093411996067,2.343269461873004,moisture > 86.44
136,479769082262246036922958676018026582868582798710,2,1,1,0.0,0.0009034042172810766,moisture <= 86.44
137,592428781388308123196323159466738623004719793134,3,2,1,4.9164208456243856e-05,0.0022585105432026916,pH <= 5.31
138,929669822954466368781570939272616348968828867860,4,2,2,0.00025893149786955093,0.0009034042172810766,pH > 5.31
139,959120462704105490415714188478879000168094585399,2,1,1,0.00013110455588331694,0.0004517021086405383,pH <= 5.27
140,14031532405571743634624912828080204254597625767,5,2,3,0.0021435594886922323,1.8459952057085363,pH > 5.17
141,1405245601027660786125741477698000295615911050563,6,2,4,0.011563421828908554,1.9528665320026006,Pheno > 0.66
142,1447020924709357829249665852444662160906055523561,3,2,1,3.9331366764995083e-05,0.0027102126518432296,pH <= 4.99
143,1405395433493292145183461183700747787876089761855,2,1,1,9.832841691248771e-05,0.0067755316296080744,pH <= 4.25
144,1407297874136257079765221640217452983945897594252,2,1,1,0.0,0.0009034042172810766,Brix <= 8.85
145,1407581683805253225904385650399158920290145895085,6,2,4,0.009026548672566371,2.8032950780995862,Brix > 8.9
146,1419672045835053177656061389410347597700670946936,2,1,1,0.00011799410029498524,0.0009034042172810766,moisture > 84.66
147,1422967542425949721261238579709952580993794609712,5,2,3,0.0029891838741396264,0.028005530735713373,Brix > 10.68
148,988013392528626659652324335175339418871169925632,2,1,1,0.0,0.007678935846889151,pH <= 4.24
149,1427828628260900981801428293654733815387871495302,2,1,1,3.9331366764995083e-05,0.0027102126518432296,Brix > 11.53
150,1439464955386705651918278339040352366460275629035,3,1,2,0.01136676499508358,1.9956223427007342,pH > 4.76
151,846755632185994819502766419529589014377703441472,3,1,2,0.012704031465093413,2.053828951432482,Brix <= 12.0
152,256288126087786619687897411359903317376520578515,2,1,1,0.0,0.0009034042172810766,Brix <= 11.2
153,382306255640768803407450227941569918411826841725,2,1,1,0.00011799410029498524,0.0004517021086405383,Brix > 11.62
154,992276951130140076069564900606041387590736103754,2,1,1,5.899705014749262e-05,0.0004517021086405383,Brix <= 11.62
155,1461491637305270569282591834691973306303985111158,3,1,2,0.032055063913470995,1.5177780854551266,Brix > 11.8
156,152935007753372584030590172629195254188452520644,3,1,2,0.005880039331366765,1.4664346076605375,Brix > 10.65
157,160691877793636234203031725388134742949489255950,3,1,2,0.0006882989183874139,2.365308288030498,moisture > 84.24
158,160923170454846684833665203962267018672724733459,2,1,1,0.0,0.0027102126518432296,pH > 4.62
159,41417030911434338004125230269439804259879445302,4,2,2,9.832841691248771e-05,0.0036136168691243064,Pheno > 0.78
160,763212543587750217808106594112871041545025736785,15,6,9,0.03164208456243855,2.793006780407144,Tit Acid > 0.12
161,775650655566268222195963750769541160664287144256,10,6,4,0.07901671583087512,1.6840055087128762,Tit Acid <= 0.12
162,94330844839245431503270651077146112261467374356,2,1,1,0.0,0.0009034042172810766,pH > 5.26
163,16769566651221792157231450049135750503234403831,7,1,6,0.016597836774827925,2.4112985207276356,Tit Acid > 0.25
164,190261406027496846769744968603813117614724013280,5,2,3,0.014611602753195674,2.6467571257240934,moisture <= 87.84
165,317003839622419703814735346711666784282633035456,3,1,2,0.005978367748279253,0.018971488562902608,Brix > 10.22
166,169092622019488698949013158397288175996906553312,2,1,1,1.9665683382497542e-05,0.0036136168691243064,pH > 4.03
167,17602321598437820260191588653395954663151122276,2,1,1,0.00015732546705998033,0.0004517021086405383,Brix > 11.24
168,176645373172273420828484620192855170075859691379,2,1,1,5.899705014749262e-05,0.0018068084345621532,pH <= 4.09
169,177267499210149510724253963525281511412675617616,10,2,8,0.025545722713864308,2.6666045448478854,pH > 4.75
170,314481329406331221346824442324578186096521671941,3,1,2,0.010442477876106195,1.6803660802946867,pH > 5.29
171,34329644815662990933072560594117088490383573434,2,1,1,0.0001376597836774828,0.0004517021086405383,Brix <= 11.24
172,645278343125912395094693382919361352020510465378,3,1,2,0.008751229105211407,1.8610824910928185,Brix > 8.85
173,879777753611004235437037181589738421603931041991,3,1,2,0.0,2.9425097005729404,pH <= 5.29
174,188380948886476719573524477793633683606238040340,2,1,1,0.00021632251720747297,0.0004517021086405383,pH > 5.14
175,20443890347911038642410738347573019158895268679,2,1,1,0.0,0.004517021086405383,moisture > 87.28
176,47635510756424328729794967520824764353044331683,11,3,8,0.02527040314650934,2.031653636932204,pH > 4.85
177,528566363778781775621158712241864824836897742885,2,1,1,0.0,0.0013551063259216148,Brix <= 11.65
178,5771222888430697625926571315532113256585960605,8,3,5,0.059331366764995085,2.6366283113660627,pH <= 4.85
179,253922261890430999205267669682022302178631037563,2,1,1,0.0,0.0022585105432026916,pH > 5.12
180,264180769172240921923099009387695914077031880466,2,1,1,0.0003343166175024582,0.0004517021086405383,pH <= 4.86
181,315335336196243816662376563521226888334928581913,2,1,1,0.0,0.0067755316296080744,Pheno > 0.63
182,352385157284351643314059025787919147267025032048,3,1,2,0.010894788593903639,2.6124931090985677,moisture <= 88.61
183,359496208730042371551485480368013674706588170395,2,1,1,3.9331366764995083e-05,0.0018068084345621532,pH <= 4.94
184,37775716639446480443771936493018162492062706461,4,1,3,0.006253687315634218,2.5787127895209747,Tit Acid > 0.19
185,583986802052284736324686363198003085747833615140,3,1,2,0.0030285152409046216,0.00813063795552969,Brix > 12.35
186,966847266038115199069719949186386360401023020236,3,1,2,0.004464110127826942,2.550940451440344,Brix <= 12.35
187,395157893433517205528339739200632277333043350939,2,1,1,0.0,0.0013551063259216148,pH <= 4.62
188,401451405046899860537854052310317083117014693935,3,1,2,0.00704031465093412,2.1357067524559383,moisture > 88.61
189,704362326170157818240896235218517135228275068157,2,1,1,0.0,0.005420425303686459,moisture <= 89.67
190,716241450914435212182101260787324804766153660181,3,1,2,0.00839724680432645,2.377256493201174,moisture > 89.67
191,401849052094181080436076126418024594358650184652,3,1,2,0.01048180924287119,2.306347699282176,Pheno <= 0.68
192,594766896722372750654626777443766529520430548657,2,1,1,3.9331366764995083e-05,0.0009034042172810766,pH <= 4.96
193,893931918085720507244247615538062186675227880,3,2,1,1.9665683382497542e-05,0.008582340064170227,moisture <= 84.12
194,431500440665982291877861151163819974354623898398,3,1,2,0.0471583087512291,2.750634034055236,Tit Acid <= 0.26
195,593582945782690037149796047474941708010354689197,2,1,1,0.0,0.009034042172810767,pH > 4.31
196,435432251591663184771443986739530685097320043375,1,0,1,0.0,0.0027102126518432296,Pheno <= 0.56
197,45454144829668979566464121012617294258704128459,2,1,1,0.0,0.0009034042172810766,pH <= 4.76
198,601763826219114235527910162539683904909382561581,3,1,2,0.0005506391347099312,1.902901246794424,Brix <= 10.62
199,494127393420143926044921388078061355092756508432,3,1,2,0.005978367748279253,0.021907552269066106,Tit Acid > 0.26
200,505662032645117586105020132832693601065137912470,3,1,2,0.02393313667649951,1.327178461172895,Brix <= 11.53
201,606472261887217459912504716286461793220012175689,2,1,1,1.9665683382497542e-05,0.0018068084345621532,moisture > 85.13
202,867891166252050599975181215235547111412275904906,2,1,1,1.9665683382497542e-05,0.0009034042172810766,moisture <= 85.13
203,526047352448732854443680809168250965427631523486,5,2,3,0.0030285152409046216,0.005872127412326998,pH <= 4.98
204,549746515891163843617425559522791667429845420065,3,1,2,0.0031071779744346116,0.024391913866589066,moisture <= 87.83
205,665349927789854546665190254614539114508329105543,2,1,1,1.9665683382497542e-05,0.005420425303686459,pH > 4.25
206,969155621814931029403414990471813815682308915928,2,1,1,0.0003736479842674533,0.0004517021086405383,moisture <= 84.18
207,55923346877840428698347323406582099240301384625,2,1,1,4.9164208456243856e-05,0.0004517021086405383,moisture > 86.84
208,568484349403032706442811090722432144818001088423,2,1,1,2.949852507374631e-05,0.0009034042172810766,pH <= 4.32
209,760690807701745161922384972988751015502868077734,3,1,2,0.00456243854473943,0.0036136168691243064,Brix > 10.25
210,868178698416958623881163015092076504008241750906,2,1,1,0.0,0.0036136168691243064,Brix <= 10.25
211,832773610056439029892754125124439324367450502547,2,1,1,7.866273352999017e-05,0.0004517021086405383,pH <= 3.96
212,591885969784043405678088549818395643409737559965,2,1,1,0.0,0.0022585105432026916,moisture <= 86.84
213,597240793788279097482678786121035081124008541581,2,1,1,3.9331366764995083e-05,0.0036136168691243064,pH > 4.86
214,602598630478483288029339331728879842549488786305,2,1,1,0.0,0.0036136168691243064,Brix <= 11.8
215,895341986559537670622554184047363489737530876707,2,1,1,1.9665683382497542e-05,0.0022585105432026916,Brix > 9.38
216,972948545649733030197121650868510688720440557436,2,1,1,0.0,0.0022585105432026916,Brix <= 9.38
217,771605197583423849419390014360052811265050672605,2,1,1,0.0,0.0036136168691243064,moisture <= 84.24
218,679457994161468121604690233924775229118954641934,2,1,1,3.9331366764995083e-05,0.0013551063259216148,pH > 4.32
219,792760025352293005683938330994589112688689251669,2,1,1,3.9331366764995083e-05,0.004517021086405383,moisture > 87.83
220,734688343688369556113059663312243972070074525881,2,1,1,0.00017699115044247788,0.0018068084345621532,pH <= 5.12
221,825792580619614131751020977051041803762036359722,3,2,1,0.0,0.00813063795552969,pH > 4.98
222,953013916229408958655391420495312068437993458202,7,2,5,0.04890855457227138,2.8660398414995787,pH <= 4.75
223,763950697541158696363668447456846400874782411362,2,1,1,5.899705014749262e-05,0.0013551063259216148,Brix > 11.72
224,993220505241451504412699202801575240176639188473,3,1,2,0.014060963618485743,2.3273397926686843,moisture <= 87.66
225,929991558533201463690147621459319073435429710754,2,1,1,0.0,0.0013551063259216148,Brix <= 11.72
226,993598645401710847477252614412509615077137993235,2,0,2,0.0,2.23756232268083,Brix <= 11.03
